game_id,home_team,away_team,season_type,week,total_home_score,total_away_score,season,pts_H_minus_A
2018_01_ATL_PHI,PHI,ATL,REG,1,18,12,2018,6
2018_01_BUF_BAL,BAL,BUF,REG,1,47,3,2018,44
2018_01_CHI_GB,GB,CHI,REG,1,24,23,2018,1
2018_01_CIN_IND,IND,CIN,REG,1,23,34,2018,-11
2018_01_DAL_CAR,CAR,DAL,REG,1,16,8,2018,8
2018_01_HOU_NE,NE,HOU,REG,1,27,20,2018,7
2018_01_JAX_NYG,NYG,JAX,REG,1,15,20,2018,-5
2018_01_KC_LAC,LAC,KC,REG,1,28,38,2018,-10
2018_01_LA_OAK,LV,LA,REG,1,13,33,2018,-20
2018_01_NYJ_DET,DET,NYJ,REG,1,17,48,2018,-31
2018_01_PIT_CLE,CLE,PIT,REG,1,21,21,2018,0
2018_01_SEA_DEN,DEN,SEA,REG,1,27,24,2018,3
2018_01_SF_MIN,MIN,SF,REG,1,24,16,2018,8
2018_01_TB_NO,NO,TB,REG,1,40,48,2018,-8
2018_01_TEN_MIA,MIA,TEN,REG,1,27,20,2018,7
2018_01_WAS_ARI,ARI,WAS,REG,1,6,24,2018,-18
2018_02_ARI_LA,LA,ARI,REG,2,34,0,2018,34
2018_02_BAL_CIN,CIN,BAL,REG,2,34,23,2018,11
2018_02_CAR_ATL,ATL,CAR,REG,2,31,24,2018,7
2018_02_CLE_NO,NO,CLE,REG,2,21,18,2018,3
2018_02_DET_SF,SF,DET,REG,2,30,27,2018,3
2018_02_HOU_TEN,TEN,HOU,REG,2,20,17,2018,3
2018_02_IND_WAS,WAS,IND,REG,2,9,21,2018,-12
2018_02_KC_PIT,PIT,KC,REG,2,37,42,2018,-5
2018_02_LAC_BUF,BUF,LAC,REG,2,20,31,2018,-11
2018_02_MIA_NYJ,NYJ,MIA,REG,2,12,20,2018,-8
2018_02_MIN_GB,GB,MIN,REG,2,29,29,2018,0
2018_02_NE_JAX,JAX,NE,REG,2,31,20,2018,11
2018_02_NYG_DAL,DAL,NYG,REG,2,20,13,2018,7
2018_02_OAK_DEN,DEN,LV,REG,2,20,19,2018,1
2018_02_PHI_TB,TB,PHI,REG,2,27,21,2018,6
2018_02_SEA_CHI,CHI,SEA,REG,2,24,17,2018,7
2018_03_BUF_MIN,MIN,BUF,REG,3,6,27,2018,-21
2018_03_CHI_ARI,ARI,CHI,REG,3,14,16,2018,-2
2018_03_CIN_CAR,CAR,CIN,REG,3,31,21,2018,10
2018_03_DAL_SEA,SEA,DAL,REG,3,24,13,2018,11
2018_03_DEN_BAL,BAL,DEN,REG,3,27,14,2018,13
2018_03_GB_WAS,WAS,GB,REG,3,31,17,2018,14
2018_03_IND_PHI,PHI,IND,REG,3,20,16,2018,4
2018_03_LAC_LA,LA,LAC,REG,3,35,23,2018,12
2018_03_NE_DET,DET,NE,REG,3,26,10,2018,16
2018_03_NO_ATL,ATL,NO,REG,3,37,43,2018,-6
2018_03_NYG_HOU,HOU,NYG,REG,3,22,27,2018,-5
2018_03_NYJ_CLE,CLE,NYJ,REG,3,21,17,2018,4
2018_03_OAK_MIA,MIA,LV,REG,3,28,20,2018,8
2018_03_PIT_TB,TB,PIT,REG,3,27,30,2018,-3
2018_03_SF_KC,KC,SF,REG,3,38,27,2018,11
2018_03_TEN_JAX,JAX,TEN,REG,3,6,9,2018,-3
2018_04_BAL_PIT,PIT,BAL,REG,4,14,26,2018,-12
2018_04_BUF_GB,GB,BUF,REG,4,22,0,2018,22
2018_04_CIN_ATL,ATL,CIN,REG,4,36,37,2018,-1
2018_04_CLE_OAK,LV,CLE,REG,4,45,42,2018,3
2018_04_DET_DAL,DAL,DET,REG,4,26,24,2018,2
2018_04_HOU_IND,IND,HOU,REG,4,34,37,2018,-3
2018_04_KC_DEN,DEN,KC,REG,4,23,27,2018,-4
2018_04_MIA_NE,NE,MIA,REG,4,38,7,2018,31
2018_04_MIN_LA,LA,MIN,REG,4,38,31,2018,7
2018_04_NO_NYG,NYG,NO,REG,4,18,33,2018,-15
2018_04_NYJ_JAX,JAX,NYJ,REG,4,31,12,2018,19
2018_04_PHI_TEN,TEN,PHI,REG,4,26,23,2018,3
2018_04_SEA_ARI,ARI,SEA,REG,4,17,20,2018,-3
2018_04_SF_LAC,LAC,SF,REG,4,29,27,2018,2
2018_04_TB_CHI,CHI,TB,REG,4,48,10,2018,38
2018_05_ARI_SF,SF,ARI,REG,5,18,28,2018,-10
2018_05_ATL_PIT,PIT,ATL,REG,5,41,17,2018,24
2018_05_BAL_CLE,CLE,BAL,REG,5,12,9,2018,3
2018_05_DAL_HOU,HOU,DAL,REG,5,19,16,2018,3
2018_05_DEN_NYJ,NYJ,DEN,REG,5,34,16,2018,18
2018_05_GB_DET,DET,GB,REG,5,31,23,2018,8
2018_05_IND_NE,NE,IND,REG,5,38,24,2018,14
2018_05_JAX_KC,KC,JAX,REG,5,30,14,2018,16
2018_05_LA_SEA,SEA,LA,REG,5,31,33,2018,-2
2018_05_MIA_CIN,CIN,MIA,REG,5,27,17,2018,10
2018_05_MIN_PHI,PHI,MIN,REG,5,21,23,2018,-2
2018_05_NYG_CAR,CAR,NYG,REG,5,33,31,2018,2
2018_05_OAK_LAC,LAC,LV,REG,5,26,10,2018,16
2018_05_TEN_BUF,BUF,TEN,REG,5,13,12,2018,1
2018_05_WAS_NO,NO,WAS,REG,5,43,19,2018,24
2018_06_ARI_MIN,MIN,ARI,REG,6,27,17,2018,10
2018_06_BAL_TEN,TEN,BAL,REG,6,0,21,2018,-21
2018_06_BUF_HOU,HOU,BUF,REG,6,20,13,2018,7
2018_06_CAR_WAS,WAS,CAR,REG,6,23,17,2018,6
2018_06_CHI_MIA,MIA,CHI,REG,6,31,28,2018,3
2018_06_IND_NYJ,NYJ,IND,REG,6,42,34,2018,8
2018_06_JAX_DAL,DAL,JAX,REG,6,40,7,2018,33
2018_06_KC_NE,NE,KC,REG,6,43,40,2018,3
2018_06_LA_DEN,DEN,LA,REG,6,20,23,2018,-3
2018_06_LAC_CLE,CLE,LAC,REG,6,14,38,2018,-24
2018_06_PHI_NYG,NYG,PHI,REG,6,13,34,2018,-21
2018_06_PIT_CIN,CIN,PIT,REG,6,21,28,2018,-7
2018_06_SEA_OAK,LV,SEA,REG,6,3,27,2018,-24
2018_06_SF_GB,GB,SF,REG,6,33,30,2018,3
2018_06_TB_ATL,ATL,TB,REG,6,34,29,2018,5
2018_07_BUF_IND,IND,BUF,REG,7,37,5,2018,32
2018_07_CAR_PHI,PHI,CAR,REG,7,17,21,2018,-4
2018_07_CIN_KC,KC,CIN,REG,7,45,10,2018,35
2018_07_CLE_TB,TB,CLE,REG,7,26,23,2018,3
2018_07_DAL_WAS,WAS,DAL,REG,7,20,17,2018,3
2018_07_DEN_ARI,ARI,DEN,REG,7,10,45,2018,-35
2018_07_DET_MIA,MIA,DET,REG,7,21,32,2018,-11
2018_07_HOU_JAX,JAX,HOU,REG,7,7,20,2018,-13
2018_07_LA_SF,SF,LA,REG,7,10,39,2018,-29
2018_07_MIN_NYJ,NYJ,MIN,REG,7,17,37,2018,-20
2018_07_NE_CHI,CHI,NE,REG,7,31,38,2018,-7
2018_07_NO_BAL,BAL,NO,REG,7,23,24,2018,-1
2018_07_NYG_ATL,ATL,NYG,REG,7,23,20,2018,3
2018_07_TEN_LAC,LAC,TEN,REG,7,20,19,2018,1
2018_08_BAL_CAR,CAR,BAL,REG,8,36,21,2018,15
2018_08_CLE_PIT,PIT,CLE,REG,8,33,18,2018,15
2018_08_DEN_KC,KC,DEN,REG,8,30,23,2018,7
2018_08_GB_LA,LA,GB,REG,8,29,27,2018,2
2018_08_IND_OAK,LV,IND,REG,8,28,42,2018,-14
2018_08_MIA_HOU,HOU,MIA,REG,8,42,23,2018,19
2018_08_NE_BUF,BUF,NE,REG,8,6,25,2018,-19
2018_08_NO_MIN,MIN,NO,REG,8,20,30,2018,-10
2018_08_NYJ_CHI,CHI,NYJ,REG,8,24,10,2018,14
2018_08_PHI_JAX,JAX,PHI,REG,8,18,24,2018,-6
2018_08_SEA_DET,DET,SEA,REG,8,14,28,2018,-14
2018_08_SF_ARI,ARI,SF,REG,8,18,15,2018,3
2018_08_TB_CIN,CIN,TB,REG,8,37,34,2018,3
2018_08_WAS_NYG,NYG,WAS,REG,8,13,20,2018,-7
2018_09_ATL_WAS,WAS,ATL,REG,9,14,38,2018,-24
2018_09_CHI_BUF,BUF,CHI,REG,9,9,41,2018,-32
2018_09_DET_MIN,MIN,DET,REG,9,24,9,2018,15
2018_09_GB_NE,NE,GB,REG,9,31,17,2018,14
2018_09_HOU_DEN,DEN,HOU,REG,9,17,19,2018,-2
2018_09_KC_CLE,CLE,KC,REG,9,21,37,2018,-16
2018_09_LA_NO,NO,LA,REG,9,45,35,2018,10
2018_09_LAC_SEA,SEA,LAC,REG,9,17,25,2018,-8
2018_09_NYJ_MIA,MIA,NYJ,REG,9,13,6,2018,7
2018_09_OAK_SF,SF,LV,REG,9,34,3,2018,31
2018_09_PIT_BAL,BAL,PIT,REG,9,16,23,2018,-7
2018_09_TB_CAR,CAR,TB,REG,9,42,28,2018,14
2018_09_TEN_DAL,DAL,TEN,REG,9,14,28,2018,-14
2018_10_ARI_KC,KC,ARI,REG,10,26,14,2018,12
2018_10_ATL_CLE,CLE,ATL,REG,10,28,16,2018,12
2018_10_BUF_NYJ,NYJ,BUF,REG,10,10,41,2018,-31
2018_10_CAR_PIT,PIT,CAR,REG,10,52,21,2018,31
2018_10_DAL_PHI,PHI,DAL,REG,10,20,27,2018,-7
2018_10_DET_CHI,CHI,DET,REG,10,34,22,2018,12
2018_10_JAX_IND,IND,JAX,REG,10,29,26,2018,3
2018_10_LAC_OAK,LV,LAC,REG,10,6,20,2018,-14
2018_10_MIA_GB,GB,MIA,REG,10,31,12,2018,19
2018_10_NE_TEN,TEN,NE,REG,10,34,10,2018,24
2018_10_NO_CIN,CIN,NO,REG,10,14,51,2018,-37
2018_10_NYG_SF,SF,NYG,REG,10,23,27,2018,-4
2018_10_SEA_LA,LA,SEA,REG,10,36,31,2018,5
2018_10_WAS_TB,TB,WAS,REG,10,3,16,2018,-13
2018_11_CAR_DET,DET,CAR,REG,11,20,19,2018,1
2018_11_CIN_BAL,BAL,CIN,REG,11,24,21,2018,3
2018_11_DAL_ATL,ATL,DAL,REG,11,19,22,2018,-3
2018_11_DEN_LAC,LAC,DEN,REG,11,22,23,2018,-1
2018_11_GB_SEA,SEA,GB,REG,11,27,24,2018,3
2018_11_HOU_WAS,WAS,HOU,REG,11,21,23,2018,-2
2018_11_KC_LA,LA,KC,REG,11,54,51,2018,3
2018_11_MIN_CHI,CHI,MIN,REG,11,25,20,2018,5
2018_11_OAK_ARI,ARI,LV,REG,11,21,23,2018,-2
2018_11_PHI_NO,NO,PHI,REG,11,48,7,2018,41
2018_11_PIT_JAX,JAX,PIT,REG,11,16,20,2018,-4
2018_11_TB_NYG,NYG,TB,REG,11,38,35,2018,3
2018_11_TEN_IND,IND,TEN,REG,11,38,10,2018,28
2018_12_ARI_LAC,LAC,ARI,REG,12,45,10,2018,35
2018_12_ATL_NO,NO,ATL,REG,12,31,17,2018,14
2018_12_CHI_DET,DET,CHI,REG,12,16,23,2018,-7
2018_12_CLE_CIN,CIN,CLE,REG,12,20,35,2018,-15
2018_12_GB_MIN,MIN,GB,REG,12,24,17,2018,7
2018_12_JAX_BUF,BUF,JAX,REG,12,24,21,2018,3
2018_12_MIA_IND,IND,MIA,REG,12,27,24,2018,3
2018_12_NE_NYJ,NYJ,NE,REG,12,13,27,2018,-14
2018_12_NYG_PHI,PHI,NYG,REG,12,25,22,2018,3
2018_12_OAK_BAL,BAL,LV,REG,12,34,17,2018,17
2018_12_PIT_DEN,DEN,PIT,REG,12,24,17,2018,7
2018_12_SEA_CAR,CAR,SEA,REG,12,27,30,2018,-3
2018_12_SF_TB,TB,SF,REG,12,27,9,2018,18
2018_12_TEN_HOU,HOU,TEN,REG,12,34,17,2018,17
2018_12_WAS_DAL,DAL,WAS,REG,12,31,23,2018,8
2018_13_ARI_GB,GB,ARI,REG,13,17,20,2018,-3
2018_13_BAL_ATL,ATL,BAL,REG,13,16,26,2018,-10
2018_13_BUF_MIA,MIA,BUF,REG,13,21,17,2018,4
2018_13_CAR_TB,TB,CAR,REG,13,24,17,2018,7
2018_13_CHI_NYG,NYG,CHI,REG,13,30,27,2018,3
2018_13_CLE_HOU,HOU,CLE,REG,13,29,13,2018,16
2018_13_DEN_CIN,CIN,DEN,REG,13,10,24,2018,-14
2018_13_IND_JAX,JAX,IND,REG,13,6,0,2018,6
2018_13_KC_OAK,LV,KC,REG,13,33,40,2018,-7
2018_13_LA_DET,DET,LA,REG,13,16,30,2018,-14
2018_13_LAC_PIT,PIT,LAC,REG,13,30,33,2018,-3
2018_13_MIN_NE,NE,MIN,REG,13,24,10,2018,14
2018_13_NO_DAL,DAL,NO,REG,13,13,10,2018,3
2018_13_NYJ_TEN,TEN,NYJ,REG,13,26,22,2018,4
2018_13_SF_SEA,SEA,SF,REG,13,43,16,2018,27
2018_13_WAS_PHI,PHI,WAS,REG,13,28,13,2018,15
2018_14_ATL_GB,GB,ATL,REG,14,34,20,2018,14
2018_14_BAL_KC,KC,BAL,REG,14,27,24,2018,3
2018_14_CAR_CLE,CLE,CAR,REG,14,26,20,2018,6
2018_14_CIN_LAC,LAC,CIN,REG,14,26,21,2018,5
2018_14_DEN_SF,SF,DEN,REG,14,20,14,2018,6
2018_14_DET_ARI,ARI,DET,REG,14,3,17,2018,-14
2018_14_IND_HOU,HOU,IND,REG,14,21,24,2018,-3
2018_14_JAX_TEN,TEN,JAX,REG,14,30,9,2018,21
2018_14_LA_CHI,CHI,LA,REG,14,15,6,2018,9
2018_14_MIN_SEA,SEA,MIN,REG,14,21,7,2018,14
2018_14_NE_MIA,MIA,NE,REG,14,34,33,2018,1
2018_14_NO_TB,TB,NO,REG,14,14,28,2018,-14
2018_14_NYG_WAS,WAS,NYG,REG,14,16,40,2018,-24
2018_14_NYJ_BUF,BUF,NYJ,REG,14,23,27,2018,-4
2018_14_PHI_DAL,DAL,PHI,REG,14,29,23,2018,6
2018_14_PIT_OAK,LV,PIT,REG,14,24,21,2018,3
2018_15_ARI_ATL,ATL,ARI,REG,15,40,14,2018,26
2018_15_CLE_DEN,DEN,CLE,REG,15,16,17,2018,-1
2018_15_DAL_IND,IND,DAL,REG,15,23,0,2018,23
2018_15_DET_BUF,BUF,DET,REG,15,14,13,2018,1
2018_15_GB_CHI,CHI,GB,REG,15,24,17,2018,7
2018_15_HOU_NYJ,NYJ,HOU,REG,15,22,29,2018,-7
2018_15_LAC_KC,KC,LAC,REG,15,28,29,2018,-1
2018_15_MIA_MIN,MIN,MIA,REG,15,41,17,2018,24
2018_15_NE_PIT,PIT,NE,REG,15,17,10,2018,7
2018_15_NO_CAR,CAR,NO,REG,15,9,12,2018,-3
2018_15_OAK_CIN,CIN,LV,REG,15,30,16,2018,14
2018_15_PHI_LA,LA,PHI,REG,15,23,30,2018,-7
2018_15_SEA_SF,SF,SEA,REG,15,26,23,2018,3
2018_15_TB_BAL,BAL,TB,REG,15,20,12,2018,8
2018_15_TEN_NYG,NYG,TEN,REG,15,0,17,2018,-17
2018_15_WAS_JAX,JAX,WAS,REG,15,13,16,2018,-3
2018_16_ATL_CAR,CAR,ATL,REG,16,10,24,2018,-14
2018_16_BAL_LAC,LAC,BAL,REG,16,10,22,2018,-12
2018_16_BUF_NE,NE,BUF,REG,16,24,12,2018,12
2018_16_CHI_SF,SF,CHI,REG,16,9,14,2018,-5
2018_16_CIN_CLE,CLE,CIN,REG,16,26,18,2018,8
2018_16_DEN_OAK,LV,DEN,REG,16,27,14,2018,13
2018_16_GB_NYJ,NYJ,GB,REG,16,38,44,2018,-6
2018_16_HOU_PHI,PHI,HOU,REG,16,32,30,2018,2
2018_16_JAX_MIA,MIA,JAX,REG,16,7,17,2018,-10
2018_16_KC_SEA,SEA,KC,REG,16,38,31,2018,7
2018_16_LA_ARI,ARI,LA,REG,16,9,31,2018,-22
2018_16_MIN_DET,DET,MIN,REG,16,9,27,2018,-18
2018_16_NYG_IND,IND,NYG,REG,16,28,27,2018,1
2018_16_PIT_NO,NO,PIT,REG,16,31,28,2018,3
2018_16_TB_DAL,DAL,TB,REG,16,27,20,2018,7
2018_16_WAS_TEN,TEN,WAS,REG,16,25,16,2018,9
2018_17_ARI_SEA,SEA,ARI,REG,17,27,24,2018,3
2018_17_ATL_TB,TB,ATL,REG,17,32,34,2018,-2
2018_17_CAR_NO,NO,CAR,REG,17,14,33,2018,-19
2018_17_CHI_MIN,MIN,CHI,REG,17,10,24,2018,-14
2018_17_CIN_PIT,PIT,CIN,REG,17,16,13,2018,3
2018_17_CLE_BAL,BAL,CLE,REG,17,26,24,2018,2
2018_17_DAL_NYG,NYG,DAL,REG,17,35,36,2018,-1
2018_17_DET_GB,GB,DET,REG,17,0,31,2018,-31
2018_17_IND_TEN,TEN,IND,REG,17,17,33,2018,-16
2018_17_JAX_HOU,HOU,JAX,REG,17,20,3,2018,17
2018_17_LAC_DEN,DEN,LAC,REG,17,9,23,2018,-14
2018_17_MIA_BUF,BUF,MIA,REG,17,42,17,2018,25
2018_17_NYJ_NE,NE,NYJ,REG,17,38,3,2018,35
2018_17_OAK_KC,KC,LV,REG,17,35,3,2018,32
2018_17_PHI_WAS,WAS,PHI,REG,17,0,24,2018,-24
2018_17_SF_LA,LA,SF,REG,17,48,32,2018,16
2018_18_IND_HOU,HOU,IND,POST,18,7,21,2018,-14
2018_18_LAC_BAL,BAL,LAC,POST,18,17,23,2018,-6
2018_18_PHI_CHI,CHI,PHI,POST,18,15,16,2018,-1
2018_18_SEA_DAL,DAL,SEA,POST,18,24,22,2018,2
2018_19_DAL_LA,LA,DAL,POST,19,30,22,2018,8
2018_19_IND_KC,KC,IND,POST,19,31,13,2018,18
2018_19_LAC_NE,NE,LAC,POST,19,41,28,2018,13
2018_19_PHI_NO,NO,PHI,POST,19,20,14,2018,6
2018_20_LA_NO,NO,LA,POST,20,23,26,2018,-3
2018_20_NE_KC,KC,NE,POST,20,31,37,2018,-6
2018_21_NE_LA,LA,NE,POST,21,3,13,2018,-10
2019_01_ATL_MIN,MIN,ATL,REG,1,28,12,2019,16
2019_01_BAL_MIA,MIA,BAL,REG,1,10,59,2019,-49
2019_01_BUF_NYJ,NYJ,BUF,REG,1,16,17,2019,-1
2019_01_CIN_SEA,SEA,CIN,REG,1,21,20,2019,1
2019_01_DEN_OAK,LV,DEN,REG,1,24,16,2019,8
2019_01_DET_ARI,ARI,DET,REG,1,27,27,2019,0
2019_01_GB_CHI,CHI,GB,REG,1,3,10,2019,-7
2019_01_HOU_NO,NO,HOU,REG,1,30,28,2019,2
2019_01_IND_LAC,LAC,IND,REG,1,30,24,2019,6
2019_01_KC_JAX,JAX,KC,REG,1,26,40,2019,-14
2019_01_LA_CAR,CAR,LA,REG,1,27,30,2019,-3
2019_01_NYG_DAL,DAL,NYG,REG,1,35,17,2019,18
2019_01_PIT_NE,NE,PIT,REG,1,33,3,2019,30
2019_01_SF_TB,TB,SF,REG,1,17,31,2019,-14
2019_01_TEN_CLE,CLE,TEN,REG,1,13,43,2019,-30
2019_01_WAS_PHI,PHI,WAS,REG,1,32,27,2019,5
2019_02_ARI_BAL,BAL,ARI,REG,2,23,17,2019,6
2019_02_BUF_NYG,NYG,BUF,REG,2,14,28,2019,-14
2019_02_CHI_DEN,DEN,CHI,REG,2,14,16,2019,-2
2019_02_CLE_NYJ,NYJ,CLE,REG,2,3,23,2019,-20
2019_02_DAL_WAS,WAS,DAL,REG,2,21,31,2019,-10
2019_02_IND_TEN,TEN,IND,REG,2,17,19,2019,-2
2019_02_JAX_HOU,HOU,JAX,REG,2,13,12,2019,1
2019_02_KC_OAK,LV,KC,REG,2,10,28,2019,-18
2019_02_LAC_DET,DET,LAC,REG,2,13,10,2019,3
2019_02_MIN_GB,GB,MIN,REG,2,21,16,2019,5
2019_02_NE_MIA,MIA,NE,REG,2,0,43,2019,-43
2019_02_NO_LA,LA,NO,REG,2,27,9,2019,18
2019_02_PHI_ATL,ATL,PHI,REG,2,24,20,2019,4
2019_02_SEA_PIT,PIT,SEA,REG,2,26,28,2019,-2
2019_02_SF_CIN,CIN,SF,REG,2,17,41,2019,-24
2019_02_TB_CAR,CAR,TB,REG,2,14,20,2019,-6
2019_03_ATL_IND,IND,ATL,REG,3,27,24,2019,3
2019_03_BAL_KC,KC,BAL,REG,3,33,28,2019,5
2019_03_CAR_ARI,ARI,CAR,REG,3,20,38,2019,-18
2019_03_CHI_WAS,WAS,CHI,REG,3,15,31,2019,-16
2019_03_CIN_BUF,BUF,CIN,REG,3,21,17,2019,4
2019_03_DEN_GB,GB,DEN,REG,3,27,16,2019,11
2019_03_DET_PHI,PHI,DET,REG,3,24,27,2019,-3
2019_03_HOU_LAC,LAC,HOU,REG,3,20,27,2019,-7
2019_03_LA_CLE,CLE,LA,REG,3,13,20,2019,-7
2019_03_MIA_DAL,DAL,MIA,REG,3,31,6,2019,25
2019_03_NO_SEA,SEA,NO,REG,3,27,33,2019,-6
2019_03_NYG_TB,TB,NYG,REG,3,31,32,2019,-1
2019_03_NYJ_NE,NE,NYJ,REG,3,30,14,2019,16
2019_03_OAK_MIN,MIN,LV,REG,3,34,14,2019,20
2019_03_PIT_SF,SF,PIT,REG,3,24,20,2019,4
2019_03_TEN_JAX,JAX,TEN,REG,3,20,7,2019,13
2019_04_CAR_HOU,HOU,CAR,REG,4,10,16,2019,-6
2019_04_CIN_PIT,PIT,CIN,REG,4,27,3,2019,24
2019_04_CLE_BAL,BAL,CLE,REG,4,25,40,2019,-15
2019_04_DAL_NO,NO,DAL,REG,4,12,10,2019,2
2019_04_JAX_DEN,DEN,JAX,REG,4,24,26,2019,-2
2019_04_KC_DET,DET,KC,REG,4,30,34,2019,-4
2019_04_LAC_MIA,MIA,LAC,REG,4,10,30,2019,-20
2019_04_MIN_CHI,CHI,MIN,REG,4,16,6,2019,10
2019_04_NE_BUF,BUF,NE,REG,4,10,16,2019,-6
2019_04_OAK_IND,IND,LV,REG,4,24,31,2019,-7
2019_04_PHI_GB,GB,PHI,REG,4,27,34,2019,-7
2019_04_SEA_ARI,ARI,SEA,REG,4,10,27,2019,-17
2019_04_TB_LA,LA,TB,REG,4,40,55,2019,-15
2019_04_TEN_ATL,ATL,TEN,REG,4,10,24,2019,-14
2019_04_WAS_NYG,NYG,WAS,REG,4,24,3,2019,21
2019_05_ARI_CIN,CIN,ARI,REG,5,23,26,2019,-3
2019_05_ATL_HOU,HOU,ATL,REG,5,53,32,2019,21
2019_05_BAL_PIT,PIT,BAL,REG,5,23,26,2019,-3
2019_05_BUF_TEN,TEN,BUF,REG,5,7,14,2019,-7
2019_05_CHI_OAK,LV,CHI,REG,5,24,21,2019,3
2019_05_CLE_SF,SF,CLE,REG,5,31,3,2019,28
2019_05_DEN_LAC,LAC,DEN,REG,5,13,20,2019,-7
2019_05_GB_DAL,DAL,GB,REG,5,24,34,2019,-10
2019_05_IND_KC,KC,IND,REG,5,13,19,2019,-6
2019_05_JAX_CAR,CAR,JAX,REG,5,34,27,2019,7
2019_05_LA_SEA,SEA,LA,REG,5,30,29,2019,1
2019_05_MIN_NYG,NYG,MIN,REG,5,10,28,2019,-18
2019_05_NE_WAS,WAS,NE,REG,5,7,33,2019,-26
2019_05_NYJ_PHI,PHI,NYJ,REG,5,31,6,2019,25
2019_05_TB_NO,NO,TB,REG,5,31,24,2019,7
2019_06_ATL_ARI,ARI,ATL,REG,6,34,33,2019,1
2019_06_CAR_TB,TB,CAR,REG,6,26,37,2019,-11
2019_06_CIN_BAL,BAL,CIN,REG,6,23,17,2019,6
2019_06_DAL_NYJ,NYJ,DAL,REG,6,24,22,2019,2
2019_06_DET_GB,GB,DET,REG,6,23,22,2019,1
2019_06_HOU_KC,KC,HOU,REG,6,24,31,2019,-7
2019_06_NO_JAX,JAX,NO,REG,6,6,13,2019,-7
2019_06_NYG_NE,NE,NYG,REG,6,35,14,2019,21
2019_06_PHI_MIN,MIN,PHI,REG,6,38,20,2019,18
2019_06_PIT_LAC,LAC,PIT,REG,6,17,24,2019,-7
2019_06_SEA_CLE,CLE,SEA,REG,6,28,32,2019,-4
2019_06_SF_LA,LA,SF,REG,6,7,20,2019,-13
2019_06_TEN_DEN,DEN,TEN,REG,6,16,0,2019,16
2019_06_WAS_MIA,MIA,WAS,REG,6,16,17,2019,-1
2019_07_ARI_NYG,NYG,ARI,REG,7,21,27,2019,-6
2019_07_BAL_SEA,SEA,BAL,REG,7,16,30,2019,-14
2019_07_HOU_IND,IND,HOU,REG,7,30,23,2019,7
2019_07_JAX_CIN,CIN,JAX,REG,7,17,27,2019,-10
2019_07_KC_DEN,DEN,KC,REG,7,6,30,2019,-24
2019_07_LA_ATL,ATL,LA,REG,7,10,37,2019,-27
2019_07_LAC_TEN,TEN,LAC,REG,7,23,20,2019,3
2019_07_MIA_BUF,BUF,MIA,REG,7,31,21,2019,10
2019_07_MIN_DET,DET,MIN,REG,7,30,42,2019,-12
2019_07_NE_NYJ,NYJ,NE,REG,7,0,33,2019,-33
2019_07_NO_CHI,CHI,NO,REG,7,25,36,2019,-11
2019_07_OAK_GB,GB,LV,REG,7,42,24,2019,18
2019_07_PHI_DAL,DAL,PHI,REG,7,37,10,2019,27
2019_07_SF_WAS,WAS,SF,REG,7,0,9,2019,-9
2019_08_ARI_NO,NO,ARI,REG,8,31,9,2019,22
2019_08_CAR_SF,SF,CAR,REG,8,51,13,2019,38
2019_08_CIN_LA,LA,CIN,REG,8,24,10,2019,14
2019_08_CLE_NE,NE,CLE,REG,8,27,13,2019,14
2019_08_DEN_IND,IND,DEN,REG,8,15,13,2019,2
2019_08_GB_KC,KC,GB,REG,8,24,31,2019,-7
2019_08_LAC_CHI,CHI,LAC,REG,8,16,17,2019,-1
2019_08_MIA_PIT,PIT,MIA,REG,8,27,14,2019,13
2019_08_NYG_DET,DET,NYG,REG,8,31,26,2019,5
2019_08_NYJ_JAX,JAX,NYJ,REG,8,29,15,2019,14
2019_08_OAK_HOU,HOU,LV,REG,8,27,24,2019,3
2019_08_PHI_BUF,BUF,PHI,REG,8,13,31,2019,-18
2019_08_SEA_ATL,ATL,SEA,REG,8,20,27,2019,-7
2019_08_TB_TEN,TEN,TB,REG,8,27,23,2019,4
2019_08_WAS_MIN,MIN,WAS,REG,8,19,9,2019,10
2019_09_CHI_PHI,PHI,CHI,REG,9,22,14,2019,8
2019_09_CLE_DEN,DEN,CLE,REG,9,24,19,2019,5
2019_09_DAL_NYG,NYG,DAL,REG,9,18,37,2019,-19
2019_09_DET_OAK,LV,DET,REG,9,31,24,2019,7
2019_09_GB_LAC,LAC,GB,REG,9,26,11,2019,15
2019_09_HOU_JAX,JAX,HOU,REG,9,3,26,2019,-23
2019_09_IND_PIT,PIT,IND,REG,9,26,24,2019,2
2019_09_MIN_KC,KC,MIN,REG,9,26,23,2019,3
2019_09_NE_BAL,BAL,NE,REG,9,37,20,2019,17
2019_09_NYJ_MIA,MIA,NYJ,REG,9,26,18,2019,8
2019_09_SF_ARI,ARI,SF,REG,9,25,28,2019,-3
2019_09_TB_SEA,SEA,TB,REG,9,40,34,2019,6
2019_09_TEN_CAR,CAR,TEN,REG,9,30,20,2019,10
2019_09_WAS_BUF,BUF,WAS,REG,9,24,9,2019,15
2019_10_ARI_TB,TB,ARI,REG,10,30,27,2019,3
2019_10_ATL_NO,NO,ATL,REG,10,9,26,2019,-17
2019_10_BAL_CIN,CIN,BAL,REG,10,13,49,2019,-36
2019_10_BUF_CLE,CLE,BUF,REG,10,19,16,2019,3
2019_10_CAR_GB,GB,CAR,REG,10,24,16,2019,8
2019_10_DET_CHI,CHI,DET,REG,10,20,13,2019,7
2019_10_KC_TEN,TEN,KC,REG,10,35,32,2019,3
2019_10_LA_PIT,PIT,LA,REG,10,17,12,2019,5
2019_10_LAC_OAK,LV,LAC,REG,10,26,24,2019,2
2019_10_MIA_IND,IND,MIA,REG,10,12,16,2019,-4
2019_10_MIN_DAL,DAL,MIN,REG,10,24,28,2019,-4
2019_10_NYG_NYJ,NYJ,NYG,REG,10,34,27,2019,7
2019_10_SEA_SF,SF,SEA,REG,10,24,27,2019,-3
2019_11_ARI_SF,SF,ARI,REG,11,36,26,2019,10
2019_11_ATL_CAR,CAR,ATL,REG,11,3,29,2019,-26
2019_11_BUF_MIA,MIA,BUF,REG,11,20,37,2019,-17
2019_11_CHI_LA,LA,CHI,REG,11,17,7,2019,10
2019_11_CIN_OAK,LV,CIN,REG,11,17,10,2019,7
2019_11_DAL_DET,DET,DAL,REG,11,27,35,2019,-8
2019_11_DEN_MIN,MIN,DEN,REG,11,27,23,2019,4
2019_11_HOU_BAL,BAL,HOU,REG,11,41,7,2019,34
2019_11_JAX_IND,IND,JAX,REG,11,33,13,2019,20
2019_11_KC_LAC,LAC,KC,REG,11,17,24,2019,-7
2019_11_NE_PHI,PHI,NE,REG,11,10,17,2019,-7
2019_11_NO_TB,TB,NO,REG,11,17,34,2019,-17
2019_11_NYJ_WAS,WAS,NYJ,REG,11,17,34,2019,-17
2019_11_PIT_CLE,CLE,PIT,REG,11,21,7,2019,14
2019_12_BAL_LA,LA,BAL,REG,12,6,45,2019,-39
2019_12_CAR_NO,NO,CAR,REG,12,34,31,2019,3
2019_12_DAL_NE,NE,DAL,REG,12,13,9,2019,4
2019_12_DEN_BUF,BUF,DEN,REG,12,20,3,2019,17
2019_12_DET_WAS,WAS,DET,REG,12,19,16,2019,3
2019_12_GB_SF,SF,GB,REG,12,37,8,2019,29
2019_12_IND_HOU,HOU,IND,REG,12,20,17,2019,3
2019_12_JAX_TEN,TEN,JAX,REG,12,42,20,2019,22
2019_12_MIA_CLE,CLE,MIA,REG,12,41,24,2019,17
2019_12_NYG_CHI,CHI,NYG,REG,12,19,14,2019,5
2019_12_OAK_NYJ,NYJ,LV,REG,12,34,3,2019,31
2019_12_PIT_CIN,CIN,PIT,REG,12,10,16,2019,-6
2019_12_SEA_PHI,PHI,SEA,REG,12,9,17,2019,-8
2019_12_TB_ATL,ATL,TB,REG,12,22,35,2019,-13
2019_13_BUF_DAL,DAL,BUF,REG,13,15,26,2019,-11
2019_13_CHI_DET,DET,CHI,REG,13,20,24,2019,-4
2019_13_CLE_PIT,PIT,CLE,REG,13,20,13,2019,7
2019_13_GB_NYG,NYG,GB,REG,13,13,31,2019,-18
2019_13_LA_ARI,ARI,LA,REG,13,7,34,2019,-27
2019_13_LAC_DEN,DEN,LAC,REG,13,23,20,2019,3
2019_13_MIN_SEA,SEA,MIN,REG,13,37,30,2019,7
2019_13_NE_HOU,HOU,NE,REG,13,28,22,2019,6
2019_13_NO_ATL,ATL,NO,REG,13,18,26,2019,-8
2019_13_NYJ_CIN,CIN,NYJ,REG,13,22,6,2019,16
2019_13_OAK_KC,KC,LV,REG,13,40,9,2019,31
2019_13_PHI_MIA,MIA,PHI,REG,13,37,31,2019,6
2019_13_SF_BAL,BAL,SF,REG,13,20,17,2019,3
2019_13_TB_JAX,JAX,TB,REG,13,11,28,2019,-17
2019_13_TEN_IND,IND,TEN,REG,13,17,31,2019,-14
2019_13_WAS_CAR,CAR,WAS,REG,13,21,29,2019,-8
2019_14_BAL_BUF,BUF,BAL,REG,14,17,24,2019,-7
2019_14_CAR_ATL,ATL,CAR,REG,14,40,20,2019,20
2019_14_CIN_CLE,CLE,CIN,REG,14,27,19,2019,8
2019_14_DAL_CHI,CHI,DAL,REG,14,31,24,2019,7
2019_14_DEN_HOU,HOU,DEN,REG,14,24,38,2019,-14
2019_14_DET_MIN,MIN,DET,REG,14,20,7,2019,13
2019_14_IND_TB,TB,IND,REG,14,38,35,2019,3
2019_14_KC_NE,NE,KC,REG,14,16,23,2019,-7
2019_14_LAC_JAX,JAX,LAC,REG,14,10,45,2019,-35
2019_14_MIA_NYJ,NYJ,MIA,REG,14,22,21,2019,1
2019_14_NYG_PHI,PHI,NYG,REG,14,23,17,2019,6
2019_14_PIT_ARI,ARI,PIT,REG,14,17,23,2019,-6
2019_14_SEA_LA,LA,SEA,REG,14,28,12,2019,16
2019_14_SF_NO,NO,SF,REG,14,46,48,2019,-2
2019_14_TEN_OAK,LV,TEN,REG,14,21,42,2019,-21
2019_14_WAS_GB,GB,WAS,REG,14,20,15,2019,5
2019_15_ATL_SF,SF,ATL,REG,15,22,29,2019,-7
2019_15_BUF_PIT,PIT,BUF,REG,15,10,17,2019,-7
2019_15_CHI_GB,GB,CHI,REG,15,21,13,2019,8
2019_15_CLE_ARI,ARI,CLE,REG,15,38,24,2019,14
2019_15_DEN_KC,KC,DEN,REG,15,23,3,2019,20
2019_15_HOU_TEN,TEN,HOU,REG,15,21,24,2019,-3
2019_15_IND_NO,NO,IND,REG,15,34,7,2019,27
2019_15_JAX_OAK,LV,JAX,REG,15,16,20,2019,-4
2019_15_LA_DAL,DAL,LA,REG,15,44,21,2019,23
2019_15_MIA_NYG,NYG,MIA,REG,15,36,20,2019,16
2019_15_MIN_LAC,LAC,MIN,REG,15,10,39,2019,-29
2019_15_NE_CIN,CIN,NE,REG,15,13,34,2019,-21
2019_15_NYJ_BAL,BAL,NYJ,REG,15,42,21,2019,21
2019_15_PHI_WAS,WAS,PHI,REG,15,27,37,2019,-10
2019_15_SEA_CAR,CAR,SEA,REG,15,24,30,2019,-6
2019_15_TB_DET,DET,TB,REG,15,17,38,2019,-21
2019_16_ARI_SEA,SEA,ARI,REG,16,13,27,2019,-14
2019_16_BAL_CLE,CLE,BAL,REG,16,15,31,2019,-16
2019_16_BUF_NE,NE,BUF,REG,16,24,17,2019,7
2019_16_CAR_IND,IND,CAR,REG,16,38,6,2019,32
2019_16_CIN_MIA,MIA,CIN,REG,16,38,35,2019,3
2019_16_DAL_PHI,PHI,DAL,REG,16,17,9,2019,8
2019_16_DET_DEN,DEN,DET,REG,16,27,17,2019,10
2019_16_GB_MIN,MIN,GB,REG,16,10,23,2019,-13
2019_16_HOU_TB,TB,HOU,REG,16,20,23,2019,-3
2019_16_JAX_ATL,ATL,JAX,REG,16,24,12,2019,12
2019_16_KC_CHI,CHI,KC,REG,16,3,26,2019,-23
2019_16_LA_SF,SF,LA,REG,16,34,31,2019,3
2019_16_NO_TEN,TEN,NO,REG,16,28,38,2019,-10
2019_16_NYG_WAS,WAS,NYG,REG,16,35,41,2019,-6
2019_16_OAK_LAC,LAC,LV,REG,16,17,24,2019,-7
2019_16_PIT_NYJ,NYJ,PIT,REG,16,16,10,2019,6
2019_17_ARI_LA,LA,ARI,REG,17,31,24,2019,7
2019_17_ATL_TB,TB,ATL,REG,17,22,28,2019,-6
2019_17_CHI_MIN,MIN,CHI,REG,17,19,21,2019,-2
2019_17_CLE_CIN,CIN,CLE,REG,17,33,23,2019,10
2019_17_GB_DET,DET,GB,REG,17,20,23,2019,-3
2019_17_IND_JAX,JAX,IND,REG,17,38,20,2019,18
2019_17_LAC_KC,KC,LAC,REG,17,31,21,2019,10
2019_17_MIA_NE,NE,MIA,REG,17,24,27,2019,-3
2019_17_NO_CAR,CAR,NO,REG,17,10,42,2019,-32
2019_17_NYJ_BUF,BUF,NYJ,REG,17,6,13,2019,-7
2019_17_OAK_DEN,DEN,LV,REG,17,16,15,2019,1
2019_17_PHI_NYG,NYG,PHI,REG,17,17,34,2019,-17
2019_17_PIT_BAL,BAL,PIT,REG,17,28,10,2019,18
2019_17_SF_SEA,SEA,SF,REG,17,21,26,2019,-5
2019_17_TEN_HOU,HOU,TEN,REG,17,14,35,2019,-21
2019_17_WAS_DAL,DAL,WAS,REG,17,47,16,2019,31
2019_18_BUF_HOU,HOU,BUF,POST,18,22,19,2019,3
2019_18_MIN_NO,NO,MIN,POST,18,20,26,2019,-6
2019_18_SEA_PHI,PHI,SEA,POST,18,9,17,2019,-8
2019_18_TEN_NE,NE,TEN,POST,18,13,20,2019,-7
2019_19_HOU_KC,KC,HOU,POST,19,51,31,2019,20
2019_19_MIN_SF,SF,MIN,POST,19,27,10,2019,17
2019_19_SEA_GB,GB,SEA,POST,19,28,23,2019,5
2019_19_TEN_BAL,BAL,TEN,POST,19,12,28,2019,-16
2019_20_GB_SF,SF,GB,POST,20,37,20,2019,17
2019_20_TEN_KC,KC,TEN,POST,20,35,24,2019,11
2019_21_SF_KC,KC,SF,POST,21,31,20,2019,11
2020_01_ARI_SF,SF,ARI,REG,1,20,24,2020,-4
2020_01_CHI_DET,DET,CHI,REG,1,23,27,2020,-4
2020_01_CLE_BAL,BAL,CLE,REG,1,38,6,2020,32
2020_01_DAL_LA,LA,DAL,REG,1,20,17,2020,3
2020_01_GB_MIN,MIN,GB,REG,1,34,43,2020,-9
2020_01_HOU_KC,KC,HOU,REG,1,34,20,2020,14
2020_01_IND_JAX,JAX,IND,REG,1,27,20,2020,7
2020_01_LAC_CIN,CIN,LAC,REG,1,13,16,2020,-3
2020_01_LV_CAR,CAR,LV,REG,1,30,34,2020,-4
2020_01_MIA_NE,NE,MIA,REG,1,21,11,2020,10
2020_01_NYJ_BUF,BUF,NYJ,REG,1,27,17,2020,10
2020_01_PHI_WAS,WAS,PHI,REG,1,27,17,2020,10
2020_01_PIT_NYG,NYG,PIT,REG,1,16,26,2020,-10
2020_01_SEA_ATL,ATL,SEA,REG,1,25,38,2020,-13
2020_01_TB_NO,NO,TB,REG,1,34,23,2020,11
2020_01_TEN_DEN,DEN,TEN,REG,1,14,16,2020,-2
2020_02_ATL_DAL,DAL,ATL,REG,2,40,39,2020,1
2020_02_BAL_HOU,HOU,BAL,REG,2,16,33,2020,-17
2020_02_BUF_MIA,MIA,BUF,REG,2,28,31,2020,-3
2020_02_CAR_TB,TB,CAR,REG,2,31,17,2020,14
2020_02_CIN_CLE,CLE,CIN,REG,2,35,30,2020,5
2020_02_DEN_PIT,PIT,DEN,REG,2,26,21,2020,5
2020_02_DET_GB,GB,DET,REG,2,42,21,2020,21
2020_02_JAX_TEN,TEN,JAX,REG,2,33,30,2020,3
2020_02_KC_LAC,LAC,KC,REG,2,20,23,2020,-3
2020_02_LA_PHI,PHI,LA,REG,2,19,37,2020,-18
2020_02_MIN_IND,IND,MIN,REG,2,28,11,2020,17
2020_02_NE_SEA,SEA,NE,REG,2,35,30,2020,5
2020_02_NO_LV,LV,NO,REG,2,34,24,2020,10
2020_02_NYG_CHI,CHI,NYG,REG,2,17,13,2020,4
2020_02_SF_NYJ,NYJ,SF,REG,2,13,31,2020,-18
2020_02_WAS_ARI,ARI,WAS,REG,2,30,15,2020,15
2020_03_CAR_LAC,LAC,CAR,REG,3,16,21,2020,-5
2020_03_CHI_ATL,ATL,CHI,REG,3,26,30,2020,-4
2020_03_CIN_PHI,PHI,CIN,REG,3,23,23,2020,0
2020_03_DAL_SEA,SEA,DAL,REG,3,38,31,2020,7
2020_03_DET_ARI,ARI,DET,REG,3,23,26,2020,-3
2020_03_GB_NO,NO,GB,REG,3,30,37,2020,-7
2020_03_HOU_PIT,PIT,HOU,REG,3,28,21,2020,7
2020_03_KC_BAL,BAL,KC,REG,3,20,34,2020,-14
2020_03_LA_BUF,BUF,LA,REG,3,35,32,2020,3
2020_03_LV_NE,NE,LV,REG,3,36,20,2020,16
2020_03_MIA_JAX,JAX,MIA,REG,3,13,31,2020,-18
2020_03_NYJ_IND,IND,NYJ,REG,3,36,7,2020,29
2020_03_SF_NYG,NYG,SF,REG,3,9,36,2020,-27
2020_03_TB_DEN,DEN,TB,REG,3,10,28,2020,-18
2020_03_TEN_MIN,MIN,TEN,REG,3,30,31,2020,-1
2020_03_WAS_CLE,CLE,WAS,REG,3,34,20,2020,14
2020_04_ARI_CAR,CAR,ARI,REG,4,31,21,2020,10
2020_04_ATL_GB,GB,ATL,REG,4,30,16,2020,14
2020_04_BAL_WAS,WAS,BAL,REG,4,17,31,2020,-14
2020_04_BUF_LV,LV,BUF,REG,4,23,30,2020,-7
2020_04_CLE_DAL,DAL,CLE,REG,4,38,49,2020,-11
2020_04_DEN_NYJ,NYJ,DEN,REG,4,28,37,2020,-9
2020_04_IND_CHI,CHI,IND,REG,4,11,19,2020,-8
2020_04_JAX_CIN,CIN,JAX,REG,4,33,25,2020,8
2020_04_LAC_TB,TB,LAC,REG,4,38,31,2020,7
2020_04_MIN_HOU,HOU,MIN,REG,4,23,31,2020,-8
2020_04_NE_KC,KC,NE,REG,4,26,10,2020,16
2020_04_NO_DET,DET,NO,REG,4,29,35,2020,-6
2020_04_NYG_LA,LA,NYG,REG,4,17,9,2020,8
2020_04_PHI_SF,SF,PHI,REG,4,20,25,2020,-5
2020_04_SEA_MIA,MIA,SEA,REG,4,23,31,2020,-8
2020_05_ARI_NYJ,NYJ,ARI,REG,5,10,30,2020,-20
2020_05_BUF_TEN,TEN,BUF,REG,5,42,16,2020,26
2020_05_CAR_ATL,ATL,CAR,REG,5,16,23,2020,-7
2020_05_CIN_BAL,BAL,CIN,REG,5,27,3,2020,24
2020_05_IND_CLE,CLE,IND,REG,5,32,23,2020,9
2020_05_JAX_HOU,HOU,JAX,REG,5,30,14,2020,16
2020_05_LA_WAS,WAS,LA,REG,5,10,30,2020,-20
2020_05_LAC_NO,NO,LAC,REG,5,30,27,2020,3
2020_05_LV_KC,KC,LV,REG,5,32,40,2020,-8
2020_05_MIA_SF,SF,MIA,REG,5,17,43,2020,-26
2020_05_MIN_SEA,SEA,MIN,REG,5,27,26,2020,1
2020_05_NYG_DAL,DAL,NYG,REG,5,37,34,2020,3
2020_05_PHI_PIT,PIT,PHI,REG,5,38,29,2020,9
2020_05_TB_CHI,CHI,TB,REG,5,20,19,2020,1
2020_06_ARI_DAL,DAL,ARI,REG,6,10,38,2020,-28
2020_06_ATL_MIN,MIN,ATL,REG,6,23,40,2020,-17
2020_06_BAL_PHI,PHI,BAL,REG,6,28,30,2020,-2
2020_06_CHI_CAR,CAR,CHI,REG,6,16,23,2020,-7
2020_06_CIN_IND,IND,CIN,REG,6,31,27,2020,4
2020_06_CLE_PIT,PIT,CLE,REG,6,38,7,2020,31
2020_06_DEN_NE,NE,DEN,REG,6,12,18,2020,-6
2020_06_DET_JAX,JAX,DET,REG,6,16,34,2020,-18
2020_06_GB_TB,TB,GB,REG,6,38,10,2020,28
2020_06_HOU_TEN,TEN,HOU,REG,6,42,36,2020,6
2020_06_KC_BUF,BUF,KC,REG,6,17,26,2020,-9
2020_06_LA_SF,SF,LA,REG,6,24,16,2020,8
2020_06_NYJ_MIA,MIA,NYJ,REG,6,24,0,2020,24
2020_06_WAS_NYG,NYG,WAS,REG,6,20,19,2020,1
2020_07_BUF_NYJ,NYJ,BUF,REG,7,10,18,2020,-8
2020_07_CAR_NO,NO,CAR,REG,7,27,24,2020,3
2020_07_CHI_LA,LA,CHI,REG,7,24,10,2020,14
2020_07_CLE_CIN,CIN,CLE,REG,7,34,37,2020,-3
2020_07_DAL_WAS,WAS,DAL,REG,7,25,3,2020,22
2020_07_DET_ATL,ATL,DET,REG,7,22,23,2020,-1
2020_07_GB_HOU,HOU,GB,REG,7,20,35,2020,-15
2020_07_JAX_LAC,LAC,JAX,REG,7,39,29,2020,10
2020_07_KC_DEN,DEN,KC,REG,7,16,43,2020,-27
2020_07_NYG_PHI,PHI,NYG,REG,7,22,21,2020,1
2020_07_PIT_TEN,TEN,PIT,REG,7,24,27,2020,-3
2020_07_SEA_ARI,ARI,SEA,REG,7,37,34,2020,3
2020_07_SF_NE,NE,SF,REG,7,6,33,2020,-27
2020_07_TB_LV,LV,TB,REG,7,20,45,2020,-25
2020_08_ATL_CAR,CAR,ATL,REG,8,17,25,2020,-8
2020_08_DAL_PHI,PHI,DAL,REG,8,23,9,2020,14
2020_08_IND_DET,DET,IND,REG,8,21,41,2020,-20
2020_08_LA_MIA,MIA,LA,REG,8,28,17,2020,11
2020_08_LAC_DEN,DEN,LAC,REG,8,31,30,2020,1
2020_08_LV_CLE,CLE,LV,REG,8,6,16,2020,-10
2020_08_MIN_GB,GB,MIN,REG,8,22,28,2020,-6
2020_08_NE_BUF,BUF,NE,REG,8,24,21,2020,3
2020_08_NO_CHI,CHI,NO,REG,8,23,26,2020,-3
2020_08_NYJ_KC,KC,NYJ,REG,8,35,9,2020,26
2020_08_PIT_BAL,BAL,PIT,REG,8,24,28,2020,-4
2020_08_SF_SEA,SEA,SF,REG,8,37,27,2020,10
2020_08_TB_NYG,NYG,TB,REG,8,23,25,2020,-2
2020_08_TEN_CIN,CIN,TEN,REG,8,31,20,2020,11
2020_09_BAL_IND,IND,BAL,REG,9,10,24,2020,-14
2020_09_CAR_KC,KC,CAR,REG,9,33,31,2020,2
2020_09_CHI_TEN,TEN,CHI,REG,9,24,17,2020,7
2020_09_DEN_ATL,ATL,DEN,REG,9,34,27,2020,7
2020_09_DET_MIN,MIN,DET,REG,9,34,20,2020,14
2020_09_GB_SF,SF,GB,REG,9,17,34,2020,-17
2020_09_HOU_JAX,JAX,HOU,REG,9,25,27,2020,-2
2020_09_LV_LAC,LAC,LV,REG,9,26,31,2020,-5
2020_09_MIA_ARI,ARI,MIA,REG,9,31,34,2020,-3
2020_09_NE_NYJ,NYJ,NE,REG,9,27,30,2020,-3
2020_09_NO_TB,TB,NO,REG,9,3,38,2020,-35
2020_09_NYG_WAS,WAS,NYG,REG,9,20,23,2020,-3
2020_09_PIT_DAL,DAL,PIT,REG,9,19,24,2020,-5
2020_09_SEA_BUF,BUF,SEA,REG,9,44,34,2020,10
2020_10_BAL_NE,NE,BAL,REG,10,23,17,2020,6
2020_10_BUF_ARI,ARI,BUF,REG,10,32,30,2020,2
2020_10_CIN_PIT,PIT,CIN,REG,10,36,10,2020,26
2020_10_DEN_LV,LV,DEN,REG,10,37,12,2020,25
2020_10_HOU_CLE,CLE,HOU,REG,10,10,7,2020,3
2020_10_IND_TEN,TEN,IND,REG,10,17,34,2020,-17
2020_10_JAX_GB,GB,JAX,REG,10,24,20,2020,4
2020_10_LAC_MIA,MIA,LAC,REG,10,29,21,2020,8
2020_10_MIN_CHI,CHI,MIN,REG,10,13,19,2020,-6
2020_10_PHI_NYG,NYG,PHI,REG,10,27,17,2020,10
2020_10_SEA_LA,LA,SEA,REG,10,23,16,2020,7
2020_10_SF_NO,NO,SF,REG,10,27,13,2020,14
2020_10_TB_CAR,CAR,TB,REG,10,23,46,2020,-23
2020_10_WAS_DET,DET,WAS,REG,10,30,27,2020,3
2020_11_ARI_SEA,SEA,ARI,REG,11,28,21,2020,7
2020_11_ATL_NO,NO,ATL,REG,11,24,9,2020,15
2020_11_CIN_WAS,WAS,CIN,REG,11,20,9,2020,11
2020_11_DAL_MIN,MIN,DAL,REG,11,28,31,2020,-3
2020_11_DET_CAR,CAR,DET,REG,11,20,0,2020,20
2020_11_GB_IND,IND,GB,REG,11,34,31,2020,3
2020_11_KC_LV,LV,KC,REG,11,31,35,2020,-4
2020_11_LA_TB,TB,LA,REG,11,24,27,2020,-3
2020_11_MIA_DEN,DEN,MIA,REG,11,20,13,2020,7
2020_11_NE_HOU,HOU,NE,REG,11,27,20,2020,7
2020_11_NYJ_LAC,LAC,NYJ,REG,11,34,28,2020,6
2020_11_PHI_CLE,CLE,PHI,REG,11,22,17,2020,5
2020_11_PIT_JAX,JAX,PIT,REG,11,3,27,2020,-24
2020_11_TEN_BAL,BAL,TEN,REG,11,24,30,2020,-6
2020_12_ARI_NE,NE,ARI,REG,12,20,17,2020,3
2020_12_BAL_PIT,PIT,BAL,REG,12,19,14,2020,5
2020_12_CAR_MIN,MIN,CAR,REG,12,28,27,2020,1
2020_12_CHI_GB,GB,CHI,REG,12,41,25,2020,16
2020_12_CLE_JAX,JAX,CLE,REG,12,25,27,2020,-2
2020_12_HOU_DET,DET,HOU,REG,12,25,41,2020,-16
2020_12_KC_TB,TB,KC,REG,12,24,27,2020,-3
2020_12_LAC_BUF,BUF,LAC,REG,12,27,17,2020,10
2020_12_LV_ATL,ATL,LV,REG,12,43,6,2020,37
2020_12_MIA_NYJ,NYJ,MIA,REG,12,3,20,2020,-17
2020_12_NO_DEN,DEN,NO,REG,12,3,31,2020,-28
2020_12_NYG_CIN,CIN,NYG,REG,12,17,19,2020,-2
2020_12_SEA_PHI,PHI,SEA,REG,12,17,23,2020,-6
2020_12_SF_LA,LA,SF,REG,12,20,23,2020,-3
2020_12_TEN_IND,IND,TEN,REG,12,26,45,2020,-19
2020_12_WAS_DAL,DAL,WAS,REG,12,16,41,2020,-25
2020_13_BUF_SF,SF,BUF,REG,13,24,34,2020,-10
2020_13_CIN_MIA,MIA,CIN,REG,13,19,7,2020,12
2020_13_CLE_TEN,TEN,CLE,REG,13,35,41,2020,-6
2020_13_DAL_BAL,BAL,DAL,REG,13,34,17,2020,17
2020_13_DEN_KC,KC,DEN,REG,13,22,16,2020,6
2020_13_DET_CHI,CHI,DET,REG,13,30,34,2020,-4
2020_13_IND_HOU,HOU,IND,REG,13,20,26,2020,-6
2020_13_JAX_MIN,MIN,JAX,REG,13,27,24,2020,3
2020_13_LA_ARI,ARI,LA,REG,13,28,38,2020,-10
2020_13_LV_NYJ,NYJ,LV,REG,13,28,31,2020,-3
2020_13_NE_LAC,LAC,NE,REG,13,0,45,2020,-45
2020_13_NO_ATL,ATL,NO,REG,13,16,21,2020,-5
2020_13_NYG_SEA,SEA,NYG,REG,13,12,17,2020,-5
2020_13_PHI_GB,GB,PHI,REG,13,30,16,2020,14
2020_13_WAS_PIT,PIT,WAS,REG,13,17,23,2020,-6
2020_14_ARI_NYG,NYG,ARI,REG,14,7,26,2020,-19
2020_14_ATL_LAC,LAC,ATL,REG,14,20,17,2020,3
2020_14_BAL_CLE,CLE,BAL,REG,14,42,47,2020,-5
2020_14_DAL_CIN,CIN,DAL,REG,14,7,30,2020,-23
2020_14_DEN_CAR,CAR,DEN,REG,14,27,32,2020,-5
2020_14_GB_DET,DET,GB,REG,14,24,31,2020,-7
2020_14_HOU_CHI,CHI,HOU,REG,14,36,7,2020,29
2020_14_IND_LV,LV,IND,REG,14,27,44,2020,-17
2020_14_KC_MIA,MIA,KC,REG,14,27,33,2020,-6
2020_14_MIN_TB,TB,MIN,REG,14,26,14,2020,12
2020_14_NE_LA,LA,NE,REG,14,24,3,2020,21
2020_14_NO_PHI,PHI,NO,REG,14,24,21,2020,3
2020_14_NYJ_SEA,SEA,NYJ,REG,14,40,3,2020,37
2020_14_PIT_BUF,BUF,PIT,REG,14,26,15,2020,11
2020_14_TEN_JAX,JAX,TEN,REG,14,10,31,2020,-21
2020_14_WAS_SF,SF,WAS,REG,14,15,23,2020,-8
2020_15_BUF_DEN,DEN,BUF,REG,15,19,48,2020,-29
2020_15_CAR_GB,GB,CAR,REG,15,24,16,2020,8
2020_15_CHI_MIN,MIN,CHI,REG,15,27,33,2020,-6
2020_15_CLE_NYG,NYG,CLE,REG,15,6,20,2020,-14
2020_15_DET_TEN,TEN,DET,REG,15,46,25,2020,21
2020_15_HOU_IND,IND,HOU,REG,15,27,20,2020,7
2020_15_JAX_BAL,BAL,JAX,REG,15,40,14,2020,26
2020_15_KC_NO,NO,KC,REG,15,29,32,2020,-3
2020_15_LAC_LV,LV,LAC,REG,15,27,30,2020,-3
2020_15_NE_MIA,MIA,NE,REG,15,22,12,2020,10
2020_15_NYJ_LA,LA,NYJ,REG,15,20,23,2020,-3
2020_15_PHI_ARI,ARI,PHI,REG,15,33,26,2020,7
2020_15_PIT_CIN,CIN,PIT,REG,15,27,17,2020,10
2020_15_SEA_WAS,WAS,SEA,REG,15,15,20,2020,-5
2020_15_SF_DAL,DAL,SF,REG,15,41,33,2020,8
2020_15_TB_ATL,ATL,TB,REG,15,27,31,2020,-4
2020_16_ATL_KC,KC,ATL,REG,16,17,14,2020,3
2020_16_BUF_NE,NE,BUF,REG,16,9,38,2020,-29
2020_16_CAR_WAS,WAS,CAR,REG,16,13,20,2020,-7
2020_16_CHI_JAX,JAX,CHI,REG,16,17,41,2020,-24
2020_16_CIN_HOU,HOU,CIN,REG,16,31,37,2020,-6
2020_16_CLE_NYJ,NYJ,CLE,REG,16,23,16,2020,7
2020_16_DEN_LAC,LAC,DEN,REG,16,19,16,2020,3
2020_16_IND_PIT,PIT,IND,REG,16,28,24,2020,4
2020_16_LA_SEA,SEA,LA,REG,16,20,9,2020,11
2020_16_MIA_LV,LV,MIA,REG,16,25,26,2020,-1
2020_16_MIN_NO,NO,MIN,REG,16,52,33,2020,19
2020_16_NYG_BAL,BAL,NYG,REG,16,27,13,2020,14
2020_16_PHI_DAL,DAL,PHI,REG,16,37,17,2020,20
2020_16_SF_ARI,ARI,SF,REG,16,12,20,2020,-8
2020_16_TB_DET,DET,TB,REG,16,7,47,2020,-40
2020_16_TEN_GB,GB,TEN,REG,16,40,14,2020,26
2020_17_ARI_LA,LA,ARI,REG,17,18,7,2020,11
2020_17_ATL_TB,TB,ATL,REG,17,44,27,2020,17
2020_17_BAL_CIN,CIN,BAL,REG,17,3,38,2020,-35
2020_17_DAL_NYG,NYG,DAL,REG,17,23,19,2020,4
2020_17_GB_CHI,CHI,GB,REG,17,16,35,2020,-19
2020_17_JAX_IND,IND,JAX,REG,17,28,14,2020,14
2020_17_LAC_KC,KC,LAC,REG,17,21,38,2020,-17
2020_17_LV_DEN,DEN,LV,REG,17,31,32,2020,-1
2020_17_MIA_BUF,BUF,MIA,REG,17,56,26,2020,30
2020_17_MIN_DET,DET,MIN,REG,17,35,37,2020,-2
2020_17_NO_CAR,CAR,NO,REG,17,7,33,2020,-26
2020_17_NYJ_NE,NE,NYJ,REG,17,28,14,2020,14
2020_17_PIT_CLE,CLE,PIT,REG,17,24,22,2020,2
2020_17_SEA_SF,SF,SEA,REG,17,23,26,2020,-3
2020_17_TEN_HOU,HOU,TEN,REG,17,38,41,2020,-3
2020_17_WAS_PHI,PHI,WAS,REG,17,14,20,2020,-6
2020_18_BAL_TEN,TEN,BAL,POST,18,13,20,2020,-7
2020_18_CHI_NO,NO,CHI,POST,18,21,9,2020,12
2020_18_CLE_PIT,PIT,CLE,POST,18,37,48,2020,-11
2020_18_IND_BUF,BUF,IND,POST,18,27,24,2020,3
2020_18_LA_SEA,SEA,LA,POST,18,20,30,2020,-10
2020_18_TB_WAS,WAS,TB,POST,18,23,31,2020,-8
2020_19_BAL_BUF,BUF,BAL,POST,19,17,3,2020,14
2020_19_CLE_KC,KC,CLE,POST,19,22,17,2020,5
2020_19_LA_GB,GB,LA,POST,19,32,18,2020,14
2020_19_TB_NO,NO,TB,POST,19,20,30,2020,-10
2020_20_BUF_KC,KC,BUF,POST,20,38,24,2020,14
2020_20_TB_GB,GB,TB,POST,20,26,31,2020,-5
2020_21_KC_TB,TB,KC,POST,21,31,9,2020,22
2021_01_ARI_TEN,TEN,ARI,REG,1,13,38,2021,-25
2021_01_BAL_LV,LV,BAL,REG,1,33,27,2021,6
2021_01_CHI_LA,LA,CHI,REG,1,34,14,2021,20
2021_01_CLE_KC,KC,CLE,REG,1,33,29,2021,4
2021_01_DAL_TB,TB,DAL,REG,1,31,29,2021,2
2021_01_DEN_NYG,NYG,DEN,REG,1,13,27,2021,-14
2021_01_GB_NO,NO,GB,REG,1,38,3,2021,35
2021_01_JAX_HOU,HOU,JAX,REG,1,37,21,2021,16
2021_01_LAC_WAS,WAS,LAC,REG,1,16,20,2021,-4
2021_01_MIA_NE,NE,MIA,REG,1,16,17,2021,-1
2021_01_MIN_CIN,CIN,MIN,REG,1,27,24,2021,3
2021_01_NYJ_CAR,CAR,NYJ,REG,1,19,14,2021,5
2021_01_PHI_ATL,ATL,PHI,REG,1,6,32,2021,-26
2021_01_PIT_BUF,BUF,PIT,REG,1,16,23,2021,-7
2021_01_SEA_IND,IND,SEA,REG,1,16,28,2021,-12
2021_01_SF_DET,DET,SF,REG,1,33,41,2021,-8
2021_02_ATL_TB,TB,ATL,REG,2,48,25,2021,23
2021_02_BUF_MIA,MIA,BUF,REG,2,0,35,2021,-35
2021_02_CIN_CHI,CHI,CIN,REG,2,20,17,2021,3
2021_02_DAL_LAC,LAC,DAL,REG,2,17,20,2021,-3
2021_02_DEN_JAX,JAX,DEN,REG,2,13,23,2021,-10
2021_02_DET_GB,GB,DET,REG,2,35,17,2021,18
2021_02_HOU_CLE,CLE,HOU,REG,2,31,21,2021,10
2021_02_KC_BAL,BAL,KC,REG,2,36,35,2021,1
2021_02_LA_IND,IND,LA,REG,2,24,27,2021,-3
2021_02_LV_PIT,PIT,LV,REG,2,17,26,2021,-9
2021_02_MIN_ARI,ARI,MIN,REG,2,34,33,2021,1
2021_02_NE_NYJ,NYJ,NE,REG,2,6,25,2021,-19
2021_02_NO_CAR,CAR,NO,REG,2,26,7,2021,19
2021_02_NYG_WAS,WAS,NYG,REG,2,30,29,2021,1
2021_02_SF_PHI,PHI,SF,REG,2,11,17,2021,-6
2021_02_TEN_SEA,SEA,TEN,REG,2,30,33,2021,-3
2021_03_ARI_JAX,JAX,ARI,REG,3,19,31,2021,-12
2021_03_ATL_NYG,NYG,ATL,REG,3,14,17,2021,-3
2021_03_BAL_DET,DET,BAL,REG,3,17,19,2021,-2
2021_03_CAR_HOU,HOU,CAR,REG,3,9,24,2021,-15
2021_03_CHI_CLE,CLE,CHI,REG,3,26,6,2021,20
2021_03_CIN_PIT,PIT,CIN,REG,3,10,24,2021,-14
2021_03_GB_SF,SF,GB,REG,3,28,30,2021,-2
2021_03_IND_TEN,TEN,IND,REG,3,25,16,2021,9
2021_03_LAC_KC,KC,LAC,REG,3,24,30,2021,-6
2021_03_MIA_LV,LV,MIA,REG,3,31,28,2021,3
2021_03_NO_NE,NE,NO,REG,3,13,28,2021,-15
2021_03_NYJ_DEN,DEN,NYJ,REG,3,26,0,2021,26
2021_03_PHI_DAL,DAL,PHI,REG,3,41,21,2021,20
2021_03_SEA_MIN,MIN,SEA,REG,3,30,17,2021,13
2021_03_TB_LA,LA,TB,REG,3,34,24,2021,10
2021_03_WAS_BUF,BUF,WAS,REG,3,43,21,2021,22
2021_04_ARI_LA,LA,ARI,REG,4,20,37,2021,-17
2021_04_BAL_DEN,DEN,BAL,REG,4,7,23,2021,-16
2021_04_CAR_DAL,DAL,CAR,REG,4,36,28,2021,8
2021_04_CLE_MIN,MIN,CLE,REG,4,7,14,2021,-7
2021_04_DET_CHI,CHI,DET,REG,4,24,14,2021,10
2021_04_HOU_BUF,BUF,HOU,REG,4,40,0,2021,40
2021_04_IND_MIA,MIA,IND,REG,4,17,27,2021,-10
2021_04_JAX_CIN,CIN,JAX,REG,4,24,21,2021,3
2021_04_KC_PHI,PHI,KC,REG,4,30,42,2021,-12
2021_04_LV_LAC,LAC,LV,REG,4,28,14,2021,14
2021_04_NYG_NO,NO,NYG,REG,4,21,27,2021,-6
2021_04_PIT_GB,GB,PIT,REG,4,27,17,2021,10
2021_04_SEA_SF,SF,SEA,REG,4,21,28,2021,-7
2021_04_TB_NE,NE,TB,REG,4,17,19,2021,-2
2021_04_TEN_NYJ,NYJ,TEN,REG,4,27,24,2021,3
2021_04_WAS_ATL,ATL,WAS,REG,4,30,34,2021,-4
2021_05_BUF_KC,KC,BUF,REG,5,20,38,2021,-18
2021_05_CHI_LV,LV,CHI,REG,5,9,20,2021,-11
2021_05_CLE_LAC,LAC,CLE,REG,5,47,42,2021,5
2021_05_DEN_PIT,PIT,DEN,REG,5,27,19,2021,8
2021_05_DET_MIN,MIN,DET,REG,5,19,17,2021,2
2021_05_GB_CIN,CIN,GB,REG,5,22,25,2021,-3
2021_05_IND_BAL,BAL,IND,REG,5,31,25,2021,6
2021_05_LA_SEA,SEA,LA,REG,5,17,26,2021,-9
2021_05_MIA_TB,TB,MIA,REG,5,45,17,2021,28
2021_05_NE_HOU,HOU,NE,REG,5,22,25,2021,-3
2021_05_NO_WAS,WAS,NO,REG,5,22,33,2021,-11
2021_05_NYG_DAL,DAL,NYG,REG,5,44,20,2021,24
2021_05_NYJ_ATL,ATL,NYJ,REG,5,27,20,2021,7
2021_05_PHI_CAR,CAR,PHI,REG,5,18,21,2021,-3
2021_05_SF_ARI,ARI,SF,REG,5,17,10,2021,7
2021_05_TEN_JAX,JAX,TEN,REG,5,19,37,2021,-18
2021_06_ARI_CLE,CLE,ARI,REG,6,14,37,2021,-23
2021_06_BUF_TEN,TEN,BUF,REG,6,34,31,2021,3
2021_06_CIN_DET,DET,CIN,REG,6,11,34,2021,-23
2021_06_DAL_NE,NE,DAL,REG,6,29,35,2021,-6
2021_06_GB_CHI,CHI,GB,REG,6,14,24,2021,-10
2021_06_HOU_IND,IND,HOU,REG,6,31,3,2021,28
2021_06_KC_WAS,WAS,KC,REG,6,13,31,2021,-18
2021_06_LA_NYG,NYG,LA,REG,6,11,38,2021,-27
2021_06_LAC_BAL,BAL,LAC,REG,6,34,6,2021,28
2021_06_LV_DEN,DEN,LV,REG,6,24,34,2021,-10
2021_06_MIA_JAX,JAX,MIA,REG,6,23,20,2021,3
2021_06_MIN_CAR,CAR,MIN,REG,6,28,34,2021,-6
2021_06_SEA_PIT,PIT,SEA,REG,6,23,20,2021,3
2021_06_TB_PHI,PHI,TB,REG,6,22,28,2021,-6
2021_07_ATL_MIA,MIA,ATL,REG,7,28,30,2021,-2
2021_07_CAR_NYG,NYG,CAR,REG,7,25,3,2021,22
2021_07_CHI_TB,TB,CHI,REG,7,38,3,2021,35
2021_07_CIN_BAL,BAL,CIN,REG,7,17,41,2021,-24
2021_07_DEN_CLE,CLE,DEN,REG,7,17,14,2021,3
2021_07_DET_LA,LA,DET,REG,7,28,19,2021,9
2021_07_HOU_ARI,ARI,HOU,REG,7,31,5,2021,26
2021_07_IND_SF,SF,IND,REG,7,18,30,2021,-12
2021_07_KC_TEN,TEN,KC,REG,7,27,3,2021,24
2021_07_NO_SEA,SEA,NO,REG,7,10,13,2021,-3
2021_07_NYJ_NE,NE,NYJ,REG,7,54,13,2021,41
2021_07_PHI_LV,LV,PHI,REG,7,33,22,2021,11
2021_07_WAS_GB,GB,WAS,REG,7,24,10,2021,14
2021_08_CAR_ATL,ATL,CAR,REG,8,13,19,2021,-6
2021_08_CIN_NYJ,NYJ,CIN,REG,8,34,31,2021,3
2021_08_DAL_MIN,MIN,DAL,REG,8,16,20,2021,-4
2021_08_GB_ARI,ARI,GB,REG,8,21,24,2021,-3
2021_08_JAX_SEA,SEA,JAX,REG,8,31,7,2021,24
2021_08_LA_HOU,HOU,LA,REG,8,22,38,2021,-16
2021_08_MIA_BUF,BUF,MIA,REG,8,26,11,2021,15
2021_08_NE_LAC,LAC,NE,REG,8,24,27,2021,-3
2021_08_NYG_KC,KC,NYG,REG,8,20,17,2021,3
2021_08_PHI_DET,DET,PHI,REG,8,6,44,2021,-38
2021_08_PIT_CLE,CLE,PIT,REG,8,10,15,2021,-5
2021_08_SF_CHI,CHI,SF,REG,8,22,33,2021,-11
2021_08_TB_NO,NO,TB,REG,8,36,27,2021,9
2021_08_TEN_IND,IND,TEN,REG,8,31,34,2021,-3
2021_08_WAS_DEN,DEN,WAS,REG,8,17,10,2021,7
2021_09_ARI_SF,SF,ARI,REG,9,17,31,2021,-14
2021_09_ATL_NO,NO,ATL,REG,9,25,27,2021,-2
2021_09_BUF_JAX,JAX,BUF,REG,9,9,6,2021,3
2021_09_CHI_PIT,PIT,CHI,REG,9,29,27,2021,2
2021_09_CLE_CIN,CIN,CLE,REG,9,16,41,2021,-25
2021_09_DEN_DAL,DAL,DEN,REG,9,16,30,2021,-14
2021_09_GB_KC,KC,GB,REG,9,13,7,2021,6
2021_09_HOU_MIA,MIA,HOU,REG,9,17,9,2021,8
2021_09_LAC_PHI,PHI,LAC,REG,9,24,27,2021,-3
2021_09_LV_NYG,NYG,LV,REG,9,23,16,2021,7
2021_09_MIN_BAL,BAL,MIN,REG,9,34,31,2021,3
2021_09_NE_CAR,CAR,NE,REG,9,6,24,2021,-18
2021_09_NYJ_IND,IND,NYJ,REG,9,45,30,2021,15
2021_09_TEN_LA,LA,TEN,REG,9,16,28,2021,-12
2021_10_ATL_DAL,DAL,ATL,REG,10,43,3,2021,40
2021_10_BAL_MIA,MIA,BAL,REG,10,22,10,2021,12
2021_10_BUF_NYJ,NYJ,BUF,REG,10,17,45,2021,-28
2021_10_CAR_ARI,ARI,CAR,REG,10,10,34,2021,-24
2021_10_CLE_NE,NE,CLE,REG,10,45,7,2021,38
2021_10_DET_PIT,PIT,DET,REG,10,16,16,2021,0
2021_10_JAX_IND,IND,JAX,REG,10,23,17,2021,6
2021_10_KC_LV,LV,KC,REG,10,14,41,2021,-27
2021_10_LA_SF,SF,LA,REG,10,31,10,2021,21
2021_10_MIN_LAC,LAC,MIN,REG,10,20,27,2021,-7
2021_10_NO_TEN,TEN,NO,REG,10,23,21,2021,2
2021_10_PHI_DEN,DEN,PHI,REG,10,13,30,2021,-17
2021_10_SEA_GB,GB,SEA,REG,10,17,0,2021,17
2021_10_TB_WAS,WAS,TB,REG,10,29,19,2021,10
2021_11_ARI_SEA,SEA,ARI,REG,11,13,23,2021,-10
2021_11_BAL_CHI,CHI,BAL,REG,11,13,16,2021,-3
2021_11_CIN_LV,LV,CIN,REG,11,13,32,2021,-19
2021_11_DAL_KC,KC,DAL,REG,11,19,9,2021,10
2021_11_DET_CLE,CLE,DET,REG,11,13,10,2021,3
2021_11_GB_MIN,MIN,GB,REG,11,34,31,2021,3
2021_11_HOU_TEN,TEN,HOU,REG,11,13,22,2021,-9
2021_11_IND_BUF,BUF,IND,REG,11,15,41,2021,-26
2021_11_MIA_NYJ,NYJ,MIA,REG,11,17,24,2021,-7
2021_11_NE_ATL,ATL,NE,REG,11,0,25,2021,-25
2021_11_NO_PHI,PHI,NO,REG,11,40,29,2021,11
2021_11_NYG_TB,TB,NYG,REG,11,30,10,2021,20
2021_11_PIT_LAC,LAC,PIT,REG,11,41,37,2021,4
2021_11_SF_JAX,JAX,SF,REG,11,10,30,2021,-20
2021_11_WAS_CAR,CAR,WAS,REG,11,21,27,2021,-6
2021_12_ATL_JAX,JAX,ATL,REG,12,14,21,2021,-7
2021_12_BUF_NO,NO,BUF,REG,12,6,31,2021,-25
2021_12_CAR_MIA,MIA,CAR,REG,12,33,10,2021,23
2021_12_CHI_DET,DET,CHI,REG,12,14,16,2021,-2
2021_12_CLE_BAL,BAL,CLE,REG,12,16,10,2021,6
2021_12_LA_GB,GB,LA,REG,12,36,28,2021,8
2021_12_LAC_DEN,DEN,LAC,REG,12,28,13,2021,15
2021_12_LV_DAL,DAL,LV,REG,12,33,36,2021,-3
2021_12_MIN_SF,SF,MIN,REG,12,34,26,2021,8
2021_12_NYJ_HOU,HOU,NYJ,REG,12,14,21,2021,-7
2021_12_PHI_NYG,NYG,PHI,REG,12,13,7,2021,6
2021_12_PIT_CIN,CIN,PIT,REG,12,41,10,2021,31
2021_12_SEA_WAS,WAS,SEA,REG,12,17,15,2021,2
2021_12_TB_IND,IND,TB,REG,12,31,38,2021,-7
2021_12_TEN_NE,NE,TEN,REG,12,36,13,2021,23
2021_13_ARI_CHI,CHI,ARI,REG,13,22,33,2021,-11
2021_13_BAL_PIT,PIT,BAL,REG,13,20,19,2021,1
2021_13_DAL_NO,NO,DAL,REG,13,17,27,2021,-10
2021_13_DEN_KC,KC,DEN,REG,13,22,9,2021,13
2021_13_IND_HOU,HOU,IND,REG,13,0,31,2021,-31
2021_13_JAX_LA,LA,JAX,REG,13,37,7,2021,30
2021_13_LAC_CIN,CIN,LAC,REG,13,22,41,2021,-19
2021_13_MIN_DET,DET,MIN,REG,13,29,27,2021,2
2021_13_NE_BUF,BUF,NE,REG,13,10,14,2021,-4
2021_13_NYG_MIA,MIA,NYG,REG,13,20,9,2021,11
2021_13_PHI_NYJ,NYJ,PHI,REG,13,18,33,2021,-15
2021_13_SF_SEA,SEA,SF,REG,13,30,23,2021,7
2021_13_TB_ATL,ATL,TB,REG,13,17,30,2021,-13
2021_13_WAS_LV,LV,WAS,REG,13,15,17,2021,-2
2021_14_ATL_CAR,CAR,ATL,REG,14,21,29,2021,-8
2021_14_BAL_CLE,CLE,BAL,REG,14,24,22,2021,2
2021_14_BUF_TB,TB,BUF,REG,14,33,27,2021,6
2021_14_CHI_GB,GB,CHI,REG,14,45,30,2021,15
2021_14_DAL_WAS,WAS,DAL,REG,14,20,27,2021,-7
2021_14_DET_DEN,DEN,DET,REG,14,38,10,2021,28
2021_14_JAX_TEN,TEN,JAX,REG,14,20,0,2021,20
2021_14_LA_ARI,ARI,LA,REG,14,23,30,2021,-7
2021_14_LV_KC,KC,LV,REG,14,48,9,2021,39
2021_14_NO_NYJ,NYJ,NO,REG,14,9,30,2021,-21
2021_14_NYG_LAC,LAC,NYG,REG,14,37,21,2021,16
2021_14_PIT_MIN,MIN,PIT,REG,14,36,28,2021,8
2021_14_SEA_HOU,HOU,SEA,REG,14,13,33,2021,-20
2021_14_SF_CIN,CIN,SF,REG,14,23,26,2021,-3
2021_15_ARI_DET,DET,ARI,REG,15,30,12,2021,18
2021_15_ATL_SF,SF,ATL,REG,15,31,13,2021,18
2021_15_CAR_BUF,BUF,CAR,REG,15,31,14,2021,17
2021_15_CIN_DEN,DEN,CIN,REG,15,10,15,2021,-5
2021_15_DAL_NYG,NYG,DAL,REG,15,6,21,2021,-15
2021_15_GB_BAL,BAL,GB,REG,15,30,31,2021,-1
2021_15_HOU_JAX,JAX,HOU,REG,15,16,30,2021,-14
2021_15_KC_LAC,LAC,KC,REG,15,28,34,2021,-6
2021_15_LV_CLE,CLE,LV,REG,15,14,16,2021,-2
2021_15_MIN_CHI,CHI,MIN,REG,15,9,17,2021,-8
2021_15_NE_IND,IND,NE,REG,15,27,17,2021,10
2021_15_NO_TB,TB,NO,REG,15,0,9,2021,-9
2021_15_NYJ_MIA,MIA,NYJ,REG,15,31,24,2021,7
2021_15_SEA_LA,LA,SEA,REG,15,20,10,2021,10
2021_15_TEN_PIT,PIT,TEN,REG,15,19,13,2021,6
2021_15_WAS_PHI,PHI,WAS,REG,15,27,17,2021,10
2021_16_BAL_CIN,CIN,BAL,REG,16,41,21,2021,20
2021_16_BUF_NE,NE,BUF,REG,16,21,33,2021,-12
2021_16_CHI_SEA,SEA,CHI,REG,16,24,25,2021,-1
2021_16_CLE_GB,GB,CLE,REG,16,24,22,2021,2
2021_16_DEN_LV,LV,DEN,REG,16,17,13,2021,4
2021_16_DET_ATL,ATL,DET,REG,16,20,16,2021,4
2021_16_IND_ARI,ARI,IND,REG,16,16,22,2021,-6
2021_16_JAX_NYJ,NYJ,JAX,REG,16,26,21,2021,5
2021_16_LA_MIN,MIN,LA,REG,16,23,30,2021,-7
2021_16_LAC_HOU,HOU,LAC,REG,16,41,29,2021,12
2021_16_MIA_NO,NO,MIA,REG,16,3,20,2021,-17
2021_16_NYG_PHI,PHI,NYG,REG,16,34,10,2021,24
2021_16_PIT_KC,KC,PIT,REG,16,36,10,2021,26
2021_16_SF_TEN,TEN,SF,REG,16,20,17,2021,3
2021_16_TB_CAR,CAR,TB,REG,16,6,32,2021,-26
2021_16_WAS_DAL,DAL,WAS,REG,16,56,14,2021,42
2021_17_ARI_DAL,DAL,ARI,REG,17,22,25,2021,-3
2021_17_ATL_BUF,BUF,ATL,REG,17,29,15,2021,14
2021_17_CAR_NO,NO,CAR,REG,17,18,10,2021,8
2021_17_CLE_PIT,PIT,CLE,REG,17,26,14,2021,12
2021_17_DEN_LAC,LAC,DEN,REG,17,34,13,2021,21
2021_17_DET_SEA,SEA,DET,REG,17,51,29,2021,22
2021_17_HOU_SF,SF,HOU,REG,17,23,7,2021,16
2021_17_JAX_NE,NE,JAX,REG,17,50,10,2021,40
2021_17_KC_CIN,CIN,KC,REG,17,34,31,2021,3
2021_17_LA_BAL,BAL,LA,REG,17,19,20,2021,-1
2021_17_LV_IND,IND,LV,REG,17,20,23,2021,-3
2021_17_MIA_TEN,TEN,MIA,REG,17,34,3,2021,31
2021_17_MIN_GB,GB,MIN,REG,17,37,10,2021,27
2021_17_NYG_CHI,CHI,NYG,REG,17,29,3,2021,26
2021_17_PHI_WAS,WAS,PHI,REG,17,16,20,2021,-4
2021_17_TB_NYJ,NYJ,TB,REG,17,24,28,2021,-4
2021_18_CAR_TB,TB,CAR,REG,18,41,17,2021,24
2021_18_CHI_MIN,MIN,CHI,REG,18,31,17,2021,14
2021_18_CIN_CLE,CLE,CIN,REG,18,21,16,2021,5
2021_18_DAL_PHI,PHI,DAL,REG,18,26,51,2021,-25
2021_18_GB_DET,DET,GB,REG,18,37,30,2021,7
2021_18_IND_JAX,JAX,IND,REG,18,26,11,2021,15
2021_18_KC_DEN,DEN,KC,REG,18,24,28,2021,-4
2021_18_LAC_LV,LV,LAC,REG,18,35,32,2021,3
2021_18_NE_MIA,MIA,NE,REG,18,33,24,2021,9
2021_18_NO_ATL,ATL,NO,REG,18,20,30,2021,-10
2021_18_NYJ_BUF,BUF,NYJ,REG,18,27,10,2021,17
2021_18_PIT_BAL,BAL,PIT,REG,18,13,16,2021,-3
2021_18_SEA_ARI,ARI,SEA,REG,18,30,38,2021,-8
2021_18_SF_LA,LA,SF,REG,18,24,27,2021,-3
2021_18_TEN_HOU,HOU,TEN,REG,18,25,28,2021,-3
2021_18_WAS_NYG,NYG,WAS,REG,18,7,22,2021,-15
2021_19_ARI_LA,LA,ARI,POST,19,34,11,2021,23
2021_19_LV_CIN,CIN,LV,POST,19,26,19,2021,7
2021_19_NE_BUF,BUF,NE,POST,19,47,17,2021,30
2021_19_PHI_TB,TB,PHI,POST,19,31,15,2021,16
2021_19_PIT_KC,KC,PIT,POST,19,42,21,2021,21
2021_19_SF_DAL,DAL,SF,POST,19,17,23,2021,-6
2021_20_BUF_KC,KC,BUF,POST,20,42,36,2021,6
2021_20_CIN_TEN,TEN,CIN,POST,20,16,19,2021,-3
2021_20_LA_TB,TB,LA,POST,20,27,30,2021,-3
2021_20_SF_GB,GB,SF,POST,20,10,13,2021,-3
2021_21_CIN_KC,KC,CIN,POST,21,24,27,2021,-3
2021_21_SF_LA,LA,SF,POST,21,20,17,2021,3
2021_22_LA_CIN,CIN,LA,POST,22,20,23,2021,-3
2022_01_BAL_NYJ,NYJ,BAL,REG,1,9,24,2022,-15
2022_01_BUF_LA,LA,BUF,REG,1,10,31,2022,-21
2022_01_CLE_CAR,CAR,CLE,REG,1,24,26,2022,-2
2022_01_DEN_SEA,SEA,DEN,REG,1,17,16,2022,1
2022_01_GB_MIN,MIN,GB,REG,1,23,7,2022,16
2022_01_IND_HOU,HOU,IND,REG,1,20,20,2022,0
2022_01_JAX_WAS,WAS,JAX,REG,1,28,22,2022,6
2022_01_KC_ARI,ARI,KC,REG,1,21,44,2022,-23
2022_01_LV_LAC,LAC,LV,REG,1,24,19,2022,5
2022_01_NE_MIA,MIA,NE,REG,1,20,7,2022,13
2022_01_NO_ATL,ATL,NO,REG,1,26,27,2022,-1
2022_01_NYG_TEN,TEN,NYG,REG,1,20,21,2022,-1
2022_01_PHI_DET,DET,PHI,REG,1,36,37,2022,-1
2022_01_PIT_CIN,CIN,PIT,REG,1,21,22,2022,-1
2022_01_SF_CHI,CHI,SF,REG,1,19,10,2022,9
2022_01_TB_DAL,DAL,TB,REG,1,3,19,2022,-16
2022_02_ARI_LV,LV,ARI,REG,2,23,29,2022,-6
2022_02_ATL_LA,LA,ATL,REG,2,33,25,2022,8
2022_02_CAR_NYG,NYG,CAR,REG,2,19,16,2022,3
2022_02_CHI_GB,GB,CHI,REG,2,27,10,2022,17
2022_02_CIN_DAL,DAL,CIN,REG,2,20,17,2022,3
2022_02_HOU_DEN,DEN,HOU,REG,2,16,9,2022,7
2022_02_IND_JAX,JAX,IND,REG,2,24,0,2022,24
2022_02_LAC_KC,KC,LAC,REG,2,27,24,2022,3
2022_02_MIA_BAL,BAL,MIA,REG,2,38,42,2022,-4
2022_02_MIN_PHI,PHI,MIN,REG,2,24,7,2022,17
2022_02_NE_PIT,PIT,NE,REG,2,14,17,2022,-3
2022_02_NYJ_CLE,CLE,NYJ,REG,2,30,31,2022,-1
2022_02_SEA_SF,SF,SEA,REG,2,28,6,2022,22
2022_02_TB_NO,NO,TB,REG,2,11,19,2022,-8
2022_02_TEN_BUF,BUF,TEN,REG,2,41,7,2022,34
2022_02_WAS_DET,DET,WAS,REG,2,36,27,2022,9
2022_03_ATL_SEA,SEA,ATL,REG,3,23,27,2022,-4
2022_03_BAL_NE,NE,BAL,REG,3,26,37,2022,-11
2022_03_BUF_MIA,MIA,BUF,REG,3,21,19,2022,2
2022_03_CIN_NYJ,NYJ,CIN,REG,3,12,27,2022,-15
2022_03_DAL_NYG,NYG,DAL,REG,3,16,23,2022,-7
2022_03_DET_MIN,MIN,DET,REG,3,28,24,2022,4
2022_03_GB_TB,TB,GB,REG,3,12,14,2022,-2
2022_03_HOU_CHI,CHI,HOU,REG,3,23,20,2022,3
2022_03_JAX_LAC,LAC,JAX,REG,3,10,38,2022,-28
2022_03_KC_IND,IND,KC,REG,3,20,17,2022,3
2022_03_LA_ARI,ARI,LA,REG,3,12,20,2022,-8
2022_03_LV_TEN,TEN,LV,REG,3,24,22,2022,2
2022_03_NO_CAR,CAR,NO,REG,3,22,14,2022,8
2022_03_PHI_WAS,WAS,PHI,REG,3,8,24,2022,-16
2022_03_PIT_CLE,CLE,PIT,REG,3,29,17,2022,12
2022_03_SF_DEN,DEN,SF,REG,3,11,10,2022,1
2022_04_ARI_CAR,CAR,ARI,REG,4,16,26,2022,-10
2022_04_BUF_BAL,BAL,BUF,REG,4,20,23,2022,-3
2022_04_CHI_NYG,NYG,CHI,REG,4,20,12,2022,8
2022_04_CLE_ATL,ATL,CLE,REG,4,23,20,2022,3
2022_04_DEN_LV,LV,DEN,REG,4,32,23,2022,9
2022_04_JAX_PHI,PHI,JAX,REG,4,30,20,2022,10
2022_04_KC_TB,TB,KC,REG,4,31,41,2022,-10
2022_04_LA_SF,SF,LA,REG,4,24,9,2022,15
2022_04_LAC_HOU,HOU,LAC,REG,4,24,34,2022,-10
2022_04_MIA_CIN,CIN,MIA,REG,4,27,15,2022,12
2022_04_MIN_NO,NO,MIN,REG,4,25,28,2022,-3
2022_04_NE_GB,GB,NE,REG,4,28,23,2022,5
2022_04_NYJ_PIT,PIT,NYJ,REG,4,20,24,2022,-4
2022_04_SEA_DET,DET,SEA,REG,4,46,47,2022,-1
2022_04_TEN_IND,IND,TEN,REG,4,17,24,2022,-7
2022_04_WAS_DAL,DAL,WAS,REG,4,25,10,2022,15
2022_05_ATL_TB,TB,ATL,REG,5,21,15,2022,6
2022_05_CHI_MIN,MIN,CHI,REG,5,29,22,2022,7
2022_05_CIN_BAL,BAL,CIN,REG,5,19,17,2022,2
2022_05_DAL_LA,LA,DAL,REG,5,10,22,2022,-12
2022_05_DET_NE,NE,DET,REG,5,29,0,2022,29
2022_05_HOU_JAX,JAX,HOU,REG,5,6,13,2022,-7
2022_05_IND_DEN,DEN,IND,REG,5,9,12,2022,-3
2022_05_LAC_CLE,CLE,LAC,REG,5,28,30,2022,-2
2022_05_LV_KC,KC,LV,REG,5,30,29,2022,1
2022_05_MIA_NYJ,NYJ,MIA,REG,5,40,17,2022,23
2022_05_NYG_GB,GB,NYG,REG,5,22,27,2022,-5
2022_05_PHI_ARI,ARI,PHI,REG,5,17,20,2022,-3
2022_05_PIT_BUF,BUF,PIT,REG,5,38,3,2022,35
2022_05_SEA_NO,NO,SEA,REG,5,39,32,2022,7
2022_05_SF_CAR,CAR,SF,REG,5,16,36,2022,-20
2022_05_TEN_WAS,WAS,TEN,REG,5,17,21,2022,-4
2022_06_ARI_SEA,SEA,ARI,REG,6,19,9,2022,10
2022_06_BAL_NYG,NYG,BAL,REG,6,24,20,2022,4
2022_06_BUF_KC,KC,BUF,REG,6,20,24,2022,-4
2022_06_CAR_LA,LA,CAR,REG,6,25,9,2022,16
2022_06_CIN_NO,NO,CIN,REG,6,26,30,2022,-4
2022_06_DAL_PHI,PHI,DAL,REG,6,26,17,2022,9
2022_06_DEN_LAC,LAC,DEN,REG,6,19,16,2022,3
2022_06_JAX_IND,IND,JAX,REG,6,34,27,2022,7
2022_06_MIN_MIA,MIA,MIN,REG,6,16,24,2022,-8
2022_06_NE_CLE,CLE,NE,REG,6,15,38,2022,-23
2022_06_NYJ_GB,GB,NYJ,REG,6,11,26,2022,-15
2022_06_SF_ATL,ATL,SF,REG,6,28,14,2022,14
2022_06_TB_PIT,PIT,TB,REG,6,20,18,2022,2
2022_06_WAS_CHI,CHI,WAS,REG,6,7,12,2022,-5
2022_07_ATL_CIN,CIN,ATL,REG,7,35,17,2022,18
2022_07_CHI_NE,NE,CHI,REG,7,14,33,2022,-19
2022_07_CLE_BAL,BAL,CLE,REG,7,23,20,2022,3
2022_07_DET_DAL,DAL,DET,REG,7,24,6,2022,18
2022_07_GB_WAS,WAS,GB,REG,7,24,20,2022,4
2022_07_HOU_LV,LV,HOU,REG,7,38,20,2022,18
2022_07_IND_TEN,TEN,IND,REG,7,19,10,2022,9
2022_07_KC_SF,SF,KC,REG,7,23,44,2022,-21
2022_07_NO_ARI,ARI,NO,REG,7,42,34,2022,8
2022_07_NYG_JAX,JAX,NYG,REG,7,17,23,2022,-6
2022_07_NYJ_DEN,DEN,NYJ,REG,7,9,16,2022,-7
2022_07_PIT_MIA,MIA,PIT,REG,7,16,10,2022,6
2022_07_SEA_LAC,LAC,SEA,REG,7,23,37,2022,-14
2022_07_TB_CAR,CAR,TB,REG,7,21,3,2022,18
2022_08_ARI_MIN,MIN,ARI,REG,8,34,26,2022,8
2022_08_BAL_TB,TB,BAL,REG,8,22,27,2022,-5
2022_08_CAR_ATL,ATL,CAR,REG,8,37,34,2022,3
2022_08_CHI_DAL,DAL,CHI,REG,8,49,29,2022,20
2022_08_CIN_CLE,CLE,CIN,REG,8,32,13,2022,19
2022_08_DEN_JAX,JAX,DEN,REG,8,17,21,2022,-4
2022_08_GB_BUF,BUF,GB,REG,8,27,17,2022,10
2022_08_LV_NO,NO,LV,REG,8,24,0,2022,24
2022_08_MIA_DET,DET,MIA,REG,8,27,31,2022,-4
2022_08_NE_NYJ,NYJ,NE,REG,8,17,22,2022,-5
2022_08_NYG_SEA,SEA,NYG,REG,8,27,13,2022,14
2022_08_PIT_PHI,PHI,PIT,REG,8,35,13,2022,22
2022_08_SF_LA,LA,SF,REG,8,14,31,2022,-17
2022_08_TEN_HOU,HOU,TEN,REG,8,10,17,2022,-7
2022_08_WAS_IND,IND,WAS,REG,8,16,17,2022,-1
2022_09_BAL_NO,NO,BAL,REG,9,13,27,2022,-14
2022_09_BUF_NYJ,NYJ,BUF,REG,9,20,17,2022,3
2022_09_CAR_CIN,CIN,CAR,REG,9,42,21,2022,21
2022_09_GB_DET,DET,GB,REG,9,15,9,2022,6
2022_09_IND_NE,NE,IND,REG,9,26,3,2022,23
2022_09_LA_TB,TB,LA,REG,9,16,13,2022,3
2022_09_LAC_ATL,ATL,LAC,REG,9,17,20,2022,-3
2022_09_LV_JAX,JAX,LV,REG,9,27,20,2022,7
2022_09_MIA_CHI,CHI,MIA,REG,9,33,34,2022,-1
2022_09_MIN_WAS,WAS,MIN,REG,9,17,20,2022,-3
2022_09_PHI_HOU,HOU,PHI,REG,9,17,29,2022,-12
2022_09_SEA_ARI,ARI,SEA,REG,9,21,31,2022,-10
2022_09_TEN_KC,KC,TEN,REG,9,20,17,2022,3
2022_10_ARI_LA,LA,ARI,REG,10,17,27,2022,-10
2022_10_ATL_CAR,CAR,ATL,REG,10,25,15,2022,10
2022_10_CLE_MIA,MIA,CLE,REG,10,39,17,2022,22
2022_10_DAL_GB,GB,DAL,REG,10,31,28,2022,3
2022_10_DEN_TEN,TEN,DEN,REG,10,17,10,2022,7
2022_10_DET_CHI,CHI,DET,REG,10,31,30,2022,1
2022_10_HOU_NYG,NYG,HOU,REG,10,24,16,2022,8
2022_10_IND_LV,LV,IND,REG,10,20,25,2022,-5
2022_10_JAX_KC,KC,JAX,REG,10,27,17,2022,10
2022_10_LAC_SF,SF,LAC,REG,10,22,16,2022,6
2022_10_MIN_BUF,BUF,MIN,REG,10,31,32,2022,-1
2022_10_NO_PIT,PIT,NO,REG,10,20,10,2022,10
2022_10_SEA_TB,TB,SEA,REG,10,21,16,2022,5
2022_10_WAS_PHI,PHI,WAS,REG,10,21,32,2022,-11
2022_11_CAR_BAL,BAL,CAR,REG,11,13,3,2022,10
2022_11_CHI_ATL,ATL,CHI,REG,11,27,24,2022,3
2022_11_CIN_PIT,PIT,CIN,REG,11,30,37,2022,-7
2022_11_CLE_BUF,BUF,CLE,REG,11,31,23,2022,8
2022_11_DAL_MIN,MIN,DAL,REG,11,3,40,2022,-37
2022_11_DET_NYG,NYG,DET,REG,11,18,31,2022,-13
2022_11_KC_LAC,LAC,KC,REG,11,27,30,2022,-3
2022_11_LA_NO,NO,LA,REG,11,27,20,2022,7
2022_11_LV_DEN,DEN,LV,REG,11,16,22,2022,-6
2022_11_NYJ_NE,NE,NYJ,REG,11,10,3,2022,7
2022_11_PHI_IND,IND,PHI,REG,11,16,17,2022,-1
2022_11_SF_ARI,ARI,SF,REG,11,10,38,2022,-28
2022_11_TEN_GB,GB,TEN,REG,11,17,27,2022,-10
2022_11_WAS_HOU,HOU,WAS,REG,11,11,22,2022,-11
2022_12_ATL_WAS,WAS,ATL,REG,12,19,13,2022,6
2022_12_BAL_JAX,JAX,BAL,REG,12,28,27,2022,1
2022_12_BUF_DET,DET,BUF,REG,12,25,28,2022,-3
2022_12_CHI_NYJ,NYJ,CHI,REG,12,31,10,2022,21
2022_12_CIN_TEN,TEN,CIN,REG,12,16,20,2022,-4
2022_12_DEN_CAR,CAR,DEN,REG,12,23,10,2022,13
2022_12_GB_PHI,PHI,GB,REG,12,40,33,2022,7
2022_12_HOU_MIA,MIA,HOU,REG,12,30,15,2022,15
2022_12_LA_KC,KC,LA,REG,12,26,10,2022,16
2022_12_LAC_ARI,ARI,LAC,REG,12,24,25,2022,-1
2022_12_LV_SEA,SEA,LV,REG,12,34,40,2022,-6
2022_12_NE_MIN,MIN,NE,REG,12,33,26,2022,7
2022_12_NO_SF,SF,NO,REG,12,13,0,2022,13
2022_12_NYG_DAL,DAL,NYG,REG,12,28,20,2022,8
2022_12_PIT_IND,IND,PIT,REG,12,17,24,2022,-7
2022_12_TB_CLE,CLE,TB,REG,12,23,17,2022,6
2022_13_BUF_NE,NE,BUF,REG,13,10,24,2022,-14
2022_13_CLE_HOU,HOU,CLE,REG,13,17,24,2022,-7
2022_13_DEN_BAL,BAL,DEN,REG,13,10,9,2022,1
2022_13_GB_CHI,CHI,GB,REG,13,19,28,2022,-9
2022_13_IND_DAL,DAL,IND,REG,13,54,19,2022,35
2022_13_JAX_DET,DET,JAX,REG,13,40,14,2022,26
2022_13_KC_CIN,CIN,KC,REG,13,27,24,2022,3
2022_13_LAC_LV,LV,LAC,REG,13,28,19,2022,9
2022_13_MIA_SF,SF,MIA,REG,13,33,17,2022,16
2022_13_NO_TB,TB,NO,REG,13,17,16,2022,1
2022_13_NYJ_MIN,MIN,NYJ,REG,13,27,22,2022,5
2022_13_PIT_ATL,ATL,PIT,REG,13,16,19,2022,-3
2022_13_SEA_LA,LA,SEA,REG,13,23,27,2022,-4
2022_13_TEN_PHI,PHI,TEN,REG,13,35,10,2022,25
2022_13_WAS_NYG,NYG,WAS,REG,13,20,20,2022,0
2022_14_BAL_PIT,PIT,BAL,REG,14,14,16,2022,-2
2022_14_CAR_SEA,SEA,CAR,REG,14,24,30,2022,-6
2022_14_CLE_CIN,CIN,CLE,REG,14,23,10,2022,13
2022_14_HOU_DAL,DAL,HOU,REG,14,27,23,2022,4
2022_14_JAX_TEN,TEN,JAX,REG,14,22,36,2022,-14
2022_14_KC_DEN,DEN,KC,REG,14,29,33,2022,-4
2022_14_LV_LA,LA,LV,REG,14,17,16,2022,1
2022_14_MIA_LAC,LAC,MIA,REG,14,23,17,2022,6
2022_14_MIN_DET,DET,MIN,REG,14,34,23,2022,11
2022_14_NE_ARI,ARI,NE,REG,14,14,26,2022,-12
2022_14_NYJ_BUF,BUF,NYJ,REG,14,20,12,2022,8
2022_14_PHI_NYG,NYG,PHI,REG,14,22,48,2022,-26
2022_14_TB_SF,SF,TB,REG,14,35,7,2022,28
2022_15_ARI_DEN,DEN,ARI,REG,15,24,15,2022,9
2022_15_ATL_NO,NO,ATL,REG,15,21,18,2022,3
2022_15_BAL_CLE,CLE,BAL,REG,15,13,3,2022,10
2022_15_CIN_TB,TB,CIN,REG,15,23,34,2022,-11
2022_15_DAL_JAX,JAX,DAL,REG,15,40,34,2022,6
2022_15_DET_NYJ,NYJ,DET,REG,15,18,19,2022,-1
2022_15_IND_MIN,MIN,IND,REG,15,41,34,2022,7
2022_15_KC_HOU,HOU,KC,REG,15,24,30,2022,-6
2022_15_LA_GB,GB,LA,REG,15,24,12,2022,12
2022_15_MIA_BUF,BUF,MIA,REG,15,32,29,2022,3
2022_15_NE_LV,LV,NE,REG,15,31,23,2022,8
2022_15_NYG_WAS,WAS,NYG,REG,15,13,19,2022,-6
2022_15_PHI_CHI,CHI,PHI,REG,15,20,25,2022,-5
2022_15_PIT_CAR,CAR,PIT,REG,15,16,24,2022,-8
2022_15_SF_SEA,SEA,SF,REG,15,13,21,2022,-8
2022_15_TEN_LAC,LAC,TEN,REG,15,17,14,2022,3
2022_16_ATL_BAL,BAL,ATL,REG,16,17,9,2022,8
2022_16_BUF_CHI,CHI,BUF,REG,16,13,35,2022,-22
2022_16_CIN_NE,NE,CIN,REG,16,18,22,2022,-4
2022_16_DEN_LA,LA,DEN,REG,16,51,14,2022,37
2022_16_DET_CAR,CAR,DET,REG,16,37,23,2022,14
2022_16_GB_MIA,MIA,GB,REG,16,20,26,2022,-6
2022_16_HOU_TEN,TEN,HOU,REG,16,14,19,2022,-5
2022_16_JAX_NYJ,NYJ,JAX,REG,16,3,19,2022,-16
2022_16_LAC_IND,IND,LAC,REG,16,3,20,2022,-17
2022_16_LV_PIT,PIT,LV,REG,16,13,10,2022,3
2022_16_NO_CLE,CLE,NO,REG,16,10,17,2022,-7
2022_16_NYG_MIN,MIN,NYG,REG,16,27,24,2022,3
2022_16_PHI_DAL,DAL,PHI,REG,16,41,33,2022,8
2022_16_SEA_KC,KC,SEA,REG,16,24,10,2022,14
2022_16_TB_ARI,ARI,TB,REG,16,16,19,2022,-3
2022_16_WAS_SF,SF,WAS,REG,16,37,20,2022,17
2022_17_ARI_ATL,ATL,ARI,REG,17,20,19,2022,1
2022_17_CAR_TB,TB,CAR,REG,17,30,24,2022,6
2022_17_CHI_DET,DET,CHI,REG,17,41,10,2022,31
2022_17_CLE_WAS,WAS,CLE,REG,17,10,24,2022,-14
2022_17_DAL_TEN,TEN,DAL,REG,17,13,27,2022,-14
2022_17_DEN_KC,KC,DEN,REG,17,27,24,2022,3
2022_17_IND_NYG,NYG,IND,REG,17,38,10,2022,28
2022_17_JAX_HOU,HOU,JAX,REG,17,4,30,2022,-26
2022_17_LA_LAC,LAC,LA,REG,17,31,10,2022,21
2022_17_MIA_NE,NE,MIA,REG,17,23,21,2022,2
2022_17_MIN_GB,GB,MIN,REG,17,41,17,2022,24
2022_17_NO_PHI,PHI,NO,REG,17,11,19,2022,-8
2022_17_NYJ_SEA,SEA,NYJ,REG,17,23,6,2022,17
2022_17_PIT_BAL,BAL,PIT,REG,17,13,16,2022,-3
2022_17_SF_LV,LV,SF,REG,17,34,37,2022,-3
2022_18_ARI_SF,SF,ARI,REG,18,38,13,2022,25
2022_18_BAL_CIN,CIN,BAL,REG,18,27,16,2022,11
2022_18_CAR_NO,NO,CAR,REG,18,7,10,2022,-3
2022_18_CLE_PIT,PIT,CLE,REG,18,28,14,2022,14
2022_18_DAL_WAS,WAS,DAL,REG,18,26,6,2022,20
2022_18_DET_GB,GB,DET,REG,18,16,20,2022,-4
2022_18_HOU_IND,IND,HOU,REG,18,32,31,2022,1
2022_18_KC_LV,LV,KC,REG,18,13,31,2022,-18
2022_18_LA_SEA,SEA,LA,REG,18,19,16,2022,3
2022_18_LAC_DEN,DEN,LAC,REG,18,31,28,2022,3
2022_18_MIN_CHI,CHI,MIN,REG,18,13,29,2022,-16
2022_18_NE_BUF,BUF,NE,REG,18,35,23,2022,12
2022_18_NYG_PHI,PHI,NYG,REG,18,22,16,2022,6
2022_18_NYJ_MIA,MIA,NYJ,REG,18,11,6,2022,5
2022_18_TB_ATL,ATL,TB,REG,18,30,17,2022,13
2022_18_TEN_JAX,JAX,TEN,REG,18,20,16,2022,4
2022_19_BAL_CIN,CIN,BAL,POST,19,24,17,2022,7
2022_19_DAL_TB,TB,DAL,POST,19,14,31,2022,-17
2022_19_LAC_JAX,JAX,LAC,POST,19,31,30,2022,1
2022_19_MIA_BUF,BUF,MIA,POST,19,35,30,2022,5
2022_19_NYG_MIN,MIN,NYG,POST,19,24,31,2022,-7
2022_19_SEA_SF,SF,SEA,POST,19,41,23,2022,18
2022_20_CIN_BUF,BUF,CIN,POST,20,10,27,2022,-17
2022_20_DAL_SF,SF,DAL,POST,20,19,12,2022,7
2022_20_JAX_KC,KC,JAX,POST,20,27,20,2022,7
2022_20_NYG_PHI,PHI,NYG,POST,20,38,7,2022,31
2022_21_CIN_KC,KC,CIN,POST,21,23,20,2022,3
2022_21_SF_PHI,PHI,SF,POST,21,31,7,2022,24
2022_22_KC_PHI,PHI,KC,POST,22,36,37,2022,-1
2023_01_ARI_WAS,WAS,ARI,REG,1,20,16,2023,4
2023_01_BUF_NYJ,NYJ,BUF,REG,1,22,16,2023,6
2023_01_CAR_ATL,ATL,CAR,REG,1,24,10,2023,14
2023_01_CIN_CLE,CLE,CIN,REG,1,24,3,2023,21
2023_01_DAL_NYG,NYG,DAL,REG,1,0,40,2023,-40
2023_01_DET_KC,KC,DET,REG,1,20,21,2023,-1
2023_01_GB_CHI,CHI,GB,REG,1,20,38,2023,-18
2023_01_HOU_BAL,BAL,HOU,REG,1,25,9,2023,16
2023_01_JAX_IND,IND,JAX,REG,1,21,31,2023,-10
2023_01_LA_SEA,SEA,LA,REG,1,13,30,2023,-17
2023_01_LV_DEN,DEN,LV,REG,1,16,17,2023,-1
2023_01_MIA_LAC,LAC,MIA,REG,1,34,36,2023,-2
2023_01_PHI_NE,NE,PHI,REG,1,20,25,2023,-5
2023_01_SF_PIT,PIT,SF,REG,1,7,30,2023,-23
2023_01_TB_MIN,MIN,TB,REG,1,17,20,2023,-3
2023_01_TEN_NO,NO,TEN,REG,1,16,15,2023,1
2023_02_BAL_CIN,CIN,BAL,REG,2,24,27,2023,-3
2023_02_CHI_TB,TB,CHI,REG,2,27,17,2023,10
2023_02_CLE_PIT,PIT,CLE,REG,2,26,22,2023,4
2023_02_GB_ATL,ATL,GB,REG,2,25,24,2023,1
2023_02_IND_HOU,HOU,IND,REG,2,20,31,2023,-11
2023_02_KC_JAX,JAX,KC,REG,2,9,17,2023,-8
2023_02_LAC_TEN,TEN,LAC,REG,2,27,24,2023,3
2023_02_LV_BUF,BUF,LV,REG,2,38,10,2023,28
2023_02_MIA_NE,NE,MIA,REG,2,17,24,2023,-7
2023_02_MIN_PHI,PHI,MIN,REG,2,34,28,2023,6
2023_02_NO_CAR,CAR,NO,REG,2,17,20,2023,-3
2023_02_NYG_ARI,ARI,NYG,REG,2,28,31,2023,-3
2023_02_NYJ_DAL,DAL,NYJ,REG,2,30,10,2023,20
2023_02_SEA_DET,DET,SEA,REG,2,31,37,2023,-6
2023_02_SF_LA,LA,SF,REG,2,23,30,2023,-7
2023_02_WAS_DEN,DEN,WAS,REG,2,33,35,2023,-2
2023_03_ATL_DET,DET,ATL,REG,3,20,6,2023,14
2023_03_BUF_WAS,WAS,BUF,REG,3,3,37,2023,-34
2023_03_CAR_SEA,SEA,CAR,REG,3,37,27,2023,10
2023_03_CHI_KC,KC,CHI,REG,3,41,10,2023,31
2023_03_DAL_ARI,ARI,DAL,REG,3,28,16,2023,12
2023_03_DEN_MIA,MIA,DEN,REG,3,70,20,2023,50
2023_03_HOU_JAX,JAX,HOU,REG,3,17,37,2023,-20
2023_03_IND_BAL,BAL,IND,REG,3,19,22,2023,-3
2023_03_LA_CIN,CIN,LA,REG,3,19,16,2023,3
2023_03_LAC_MIN,MIN,LAC,REG,3,24,28,2023,-4
2023_03_NE_NYJ,NYJ,NE,REG,3,10,15,2023,-5
2023_03_NO_GB,GB,NO,REG,3,18,17,2023,1
2023_03_NYG_SF,SF,NYG,REG,3,30,12,2023,18
2023_03_PHI_TB,TB,PHI,REG,3,11,25,2023,-14
2023_03_PIT_LV,LV,PIT,REG,3,18,23,2023,-5
2023_03_TEN_CLE,CLE,TEN,REG,3,27,3,2023,24
2023_04_ARI_SF,SF,ARI,REG,4,35,16,2023,19
2023_04_ATL_JAX,JAX,ATL,REG,4,23,7,2023,16
2023_04_BAL_CLE,CLE,BAL,REG,4,3,28,2023,-25
2023_04_CIN_TEN,TEN,CIN,REG,4,27,3,2023,24
2023_04_DEN_CHI,CHI,DEN,REG,4,28,31,2023,-3
2023_04_DET_GB,GB,DET,REG,4,20,34,2023,-14
2023_04_KC_NYJ,NYJ,KC,REG,4,20,23,2023,-3
2023_04_LA_IND,IND,LA,REG,4,23,29,2023,-6
2023_04_LV_LAC,LAC,LV,REG,4,24,17,2023,7
2023_04_MIA_BUF,BUF,MIA,REG,4,48,20,2023,28
2023_04_MIN_CAR,CAR,MIN,REG,4,13,21,2023,-8
2023_04_NE_DAL,DAL,NE,REG,4,38,3,2023,35
2023_04_PIT_HOU,HOU,PIT,REG,4,30,6,2023,24
2023_04_SEA_NYG,NYG,SEA,REG,4,3,24,2023,-21
2023_04_TB_NO,NO,TB,REG,4,9,26,2023,-17
2023_04_WAS_PHI,PHI,WAS,REG,4,34,31,2023,3
2023_05_BAL_PIT,PIT,BAL,REG,5,17,10,2023,7
2023_05_CAR_DET,DET,CAR,REG,5,42,24,2023,18
2023_05_CHI_WAS,WAS,CHI,REG,5,20,40,2023,-20
2023_05_CIN_ARI,ARI,CIN,REG,5,20,34,2023,-14
2023_05_DAL_SF,SF,DAL,REG,5,42,10,2023,32
2023_05_GB_LV,LV,GB,REG,5,17,13,2023,4
2023_05_HOU_ATL,ATL,HOU,REG,5,21,19,2023,2
2023_05_JAX_BUF,BUF,JAX,REG,5,20,25,2023,-5
2023_05_KC_MIN,MIN,KC,REG,5,20,27,2023,-7
2023_05_NO_NE,NE,NO,REG,5,0,34,2023,-34
2023_05_NYG_MIA,MIA,NYG,REG,5,31,16,2023,15
2023_05_NYJ_DEN,DEN,NYJ,REG,5,21,31,2023,-10
2023_05_PHI_LA,LA,PHI,REG,5,14,23,2023,-9
2023_05_TEN_IND,IND,TEN,REG,5,23,16,2023,7
2023_06_ARI_LA,LA,ARI,REG,6,26,9,2023,17
2023_06_BAL_TEN,TEN,BAL,REG,6,16,24,2023,-8
2023_06_CAR_MIA,MIA,CAR,REG,6,42,21,2023,21
2023_06_DAL_LAC,LAC,DAL,REG,6,17,20,2023,-3
2023_06_DEN_KC,KC,DEN,REG,6,19,8,2023,11
2023_06_DET_TB,TB,DET,REG,6,6,20,2023,-14
2023_06_IND_JAX,JAX,IND,REG,6,37,20,2023,17
2023_06_MIN_CHI,CHI,MIN,REG,6,13,19,2023,-6
2023_06_NE_LV,LV,NE,REG,6,21,17,2023,4
2023_06_NO_HOU,HOU,NO,REG,6,20,13,2023,7
2023_06_NYG_BUF,BUF,NYG,REG,6,14,9,2023,5
2023_06_PHI_NYJ,NYJ,PHI,REG,6,20,14,2023,6
2023_06_SEA_CIN,CIN,SEA,REG,6,17,13,2023,4
2023_06_SF_CLE,CLE,SF,REG,6,19,17,2023,2
2023_06_WAS_ATL,ATL,WAS,REG,6,16,24,2023,-8
2023_07_ARI_SEA,SEA,ARI,REG,7,20,10,2023,10
2023_07_ATL_TB,TB,ATL,REG,7,13,16,2023,-3
2023_07_BUF_NE,NE,BUF,REG,7,29,25,2023,4
2023_07_CLE_IND,IND,CLE,REG,7,38,39,2023,-1
2023_07_DET_BAL,BAL,DET,REG,7,38,6,2023,32
2023_07_GB_DEN,DEN,GB,REG,7,19,17,2023,2
2023_07_JAX_NO,NO,JAX,REG,7,24,31,2023,-7
2023_07_LAC_KC,KC,LAC,REG,7,31,17,2023,14
2023_07_LV_CHI,CHI,LV,REG,7,30,12,2023,18
2023_07_MIA_PHI,PHI,MIA,REG,7,31,17,2023,14
2023_07_PIT_LA,LA,PIT,REG,7,17,24,2023,-7
2023_07_SF_MIN,MIN,SF,REG,7,22,17,2023,5
2023_07_WAS_NYG,NYG,WAS,REG,7,14,7,2023,7
2023_08_ATL_TEN,TEN,ATL,REG,8,28,23,2023,5
2023_08_BAL_ARI,ARI,BAL,REG,8,24,31,2023,-7
2023_08_CHI_LAC,LAC,CHI,REG,8,30,13,2023,17
2023_08_CIN_SF,SF,CIN,REG,8,17,31,2023,-14
2023_08_CLE_SEA,SEA,CLE,REG,8,24,20,2023,4
2023_08_HOU_CAR,CAR,HOU,REG,8,15,13,2023,2
2023_08_JAX_PIT,PIT,JAX,REG,8,10,20,2023,-10
2023_08_KC_DEN,DEN,KC,REG,8,24,9,2023,15
2023_08_LA_DAL,DAL,LA,REG,8,43,20,2023,23
2023_08_LV_DET,DET,LV,REG,8,26,14,2023,12
2023_08_MIN_GB,GB,MIN,REG,8,10,24,2023,-14
2023_08_NE_MIA,MIA,NE,REG,8,31,17,2023,14
2023_08_NO_IND,IND,NO,REG,8,27,38,2023,-11
2023_08_NYJ_NYG,NYG,NYJ,REG,8,10,13,2023,-3
2023_08_PHI_WAS,WAS,PHI,REG,8,31,38,2023,-7
2023_08_TB_BUF,BUF,TB,REG,8,24,18,2023,6
2023_09_ARI_CLE,CLE,ARI,REG,9,27,0,2023,27
2023_09_BUF_CIN,CIN,BUF,REG,9,24,18,2023,6
2023_09_CHI_NO,NO,CHI,REG,9,24,17,2023,7
2023_09_DAL_PHI,PHI,DAL,REG,9,28,23,2023,5
2023_09_IND_CAR,CAR,IND,REG,9,13,27,2023,-14
2023_09_LA_GB,GB,LA,REG,9,20,3,2023,17
2023_09_LAC_NYJ,NYJ,LAC,REG,9,6,27,2023,-21
2023_09_MIA_KC,KC,MIA,REG,9,21,14,2023,7
2023_09_MIN_ATL,ATL,MIN,REG,9,28,31,2023,-3
2023_09_NYG_LV,LV,NYG,REG,9,30,6,2023,24
2023_09_SEA_BAL,BAL,SEA,REG,9,37,3,2023,34
2023_09_TB_HOU,HOU,TB,REG,9,39,37,2023,2
2023_09_TEN_PIT,PIT,TEN,REG,9,20,16,2023,4
2023_09_WAS_NE,NE,WAS,REG,9,17,20,2023,-3
2023_10_ATL_ARI,ARI,ATL,REG,10,25,23,2023,2
2023_10_CAR_CHI,CHI,CAR,REG,10,16,13,2023,3
2023_10_CLE_BAL,BAL,CLE,REG,10,31,33,2023,-2
2023_10_DEN_BUF,BUF,DEN,REG,10,22,24,2023,-2
2023_10_DET_LAC,LAC,DET,REG,10,38,41,2023,-3
2023_10_GB_PIT,PIT,GB,REG,10,23,19,2023,4
2023_10_HOU_CIN,CIN,HOU,REG,10,27,30,2023,-3
2023_10_IND_NE,NE,IND,REG,10,6,10,2023,-4
2023_10_NO_MIN,MIN,NO,REG,10,27,19,2023,8
2023_10_NYG_DAL,DAL,NYG,REG,10,49,17,2023,32
2023_10_NYJ_LV,LV,NYJ,REG,10,16,12,2023,4
2023_10_SF_JAX,JAX,SF,REG,10,3,34,2023,-31
2023_10_TEN_TB,TB,TEN,REG,10,20,6,2023,14
2023_10_WAS_SEA,SEA,WAS,REG,10,29,26,2023,3
2023_11_ARI_HOU,HOU,ARI,REG,11,21,16,2023,5
2023_11_CHI_DET,DET,CHI,REG,11,31,26,2023,5
2023_11_CIN_BAL,BAL,CIN,REG,11,34,20,2023,14
2023_11_DAL_CAR,CAR,DAL,REG,11,10,33,2023,-23
2023_11_LAC_GB,GB,LAC,REG,11,23,20,2023,3
2023_11_LV_MIA,MIA,LV,REG,11,20,13,2023,7
2023_11_MIN_DEN,DEN,MIN,REG,11,21,20,2023,1
2023_11_NYG_WAS,WAS,NYG,REG,11,19,31,2023,-12
2023_11_NYJ_BUF,BUF,NYJ,REG,11,32,6,2023,26
2023_11_PHI_KC,KC,PHI,REG,11,17,21,2023,-4
2023_11_PIT_CLE,CLE,PIT,REG,11,13,10,2023,3
2023_11_SEA_LA,LA,SEA,REG,11,17,16,2023,1
2023_11_TB_SF,SF,TB,REG,11,27,14,2023,13
2023_11_TEN_JAX,JAX,TEN,REG,11,34,14,2023,20
2023_12_BAL_LAC,LAC,BAL,REG,12,10,20,2023,-10
2023_12_BUF_PHI,PHI,BUF,REG,12,37,34,2023,3
2023_12_CAR_TEN,TEN,CAR,REG,12,17,10,2023,7
2023_12_CHI_MIN,MIN,CHI,REG,12,10,12,2023,-2
2023_12_CLE_DEN,DEN,CLE,REG,12,29,12,2023,17
2023_12_GB_DET,DET,GB,REG,12,22,29,2023,-7
2023_12_JAX_HOU,HOU,JAX,REG,12,21,24,2023,-3
2023_12_KC_LV,LV,KC,REG,12,17,31,2023,-14
2023_12_LA_ARI,ARI,LA,REG,12,14,37,2023,-23
2023_12_MIA_NYJ,NYJ,MIA,REG,12,13,34,2023,-21
2023_12_NE_NYG,NYG,NE,REG,12,10,7,2023,3
2023_12_NO_ATL,ATL,NO,REG,12,24,15,2023,9
2023_12_PIT_CIN,CIN,PIT,REG,12,10,16,2023,-6
2023_12_SF_SEA,SEA,SF,REG,12,13,31,2023,-18
2023_12_TB_IND,IND,TB,REG,12,27,20,2023,7
2023_12_WAS_DAL,DAL,WAS,REG,12,45,10,2023,35
2023_13_ARI_PIT,PIT,ARI,REG,13,10,24,2023,-14
2023_13_ATL_NYJ,NYJ,ATL,REG,13,8,13,2023,-5
2023_13_CAR_TB,TB,CAR,REG,13,21,18,2023,3
2023_13_CIN_JAX,JAX,CIN,REG,13,31,34,2023,-3
2023_13_CLE_LA,LA,CLE,REG,13,36,19,2023,17
2023_13_DEN_HOU,HOU,DEN,REG,13,22,17,2023,5
2023_13_DET_NO,NO,DET,REG,13,28,33,2023,-5
2023_13_IND_TEN,TEN,IND,REG,13,28,31,2023,-3
2023_13_KC_GB,GB,KC,REG,13,27,19,2023,8
2023_13_LAC_NE,NE,LAC,REG,13,0,6,2023,-6
2023_13_MIA_WAS,WAS,MIA,REG,13,15,45,2023,-30
2023_13_SEA_DAL,DAL,SEA,REG,13,41,35,2023,6
2023_13_SF_PHI,PHI,SF,REG,13,19,42,2023,-23
2023_14_BUF_KC,KC,BUF,REG,14,17,20,2023,-3
2023_14_CAR_NO,NO,CAR,REG,14,28,6,2023,22
2023_14_DEN_LAC,LAC,DEN,REG,14,7,24,2023,-17
2023_14_DET_CHI,CHI,DET,REG,14,28,13,2023,15
2023_14_GB_NYG,NYG,GB,REG,14,24,22,2023,2
2023_14_HOU_NYJ,NYJ,HOU,REG,14,30,6,2023,24
2023_14_IND_CIN,CIN,IND,REG,14,34,14,2023,20
2023_14_JAX_CLE,CLE,JAX,REG,14,31,27,2023,4
2023_14_LA_BAL,BAL,LA,REG,14,37,31,2023,6
2023_14_MIN_LV,LV,MIN,REG,14,0,3,2023,-3
2023_14_NE_PIT,PIT,NE,REG,14,18,21,2023,-3
2023_14_PHI_DAL,DAL,PHI,REG,14,33,13,2023,20
2023_14_SEA_SF,SF,SEA,REG,14,28,16,2023,12
2023_14_TB_ATL,ATL,TB,REG,14,25,29,2023,-4
2023_14_TEN_MIA,MIA,TEN,REG,14,27,28,2023,-1
2023_15_ATL_CAR,CAR,ATL,REG,15,9,7,2023,2
2023_15_BAL_JAX,JAX,BAL,REG,15,7,23,2023,-16
2023_15_CHI_CLE,CLE,CHI,REG,15,20,17,2023,3
2023_15_DAL_BUF,BUF,DAL,REG,15,31,10,2023,21
2023_15_DEN_DET,DET,DEN,REG,15,42,17,2023,25
2023_15_HOU_TEN,TEN,HOU,REG,15,16,19,2023,-3
2023_15_KC_NE,NE,KC,REG,15,17,27,2023,-10
2023_15_LAC_LV,LV,LAC,REG,15,63,21,2023,42
2023_15_MIN_CIN,CIN,MIN,REG,15,27,24,2023,3
2023_15_NYG_NO,NO,NYG,REG,15,24,6,2023,18
2023_15_NYJ_MIA,MIA,NYJ,REG,15,30,0,2023,30
2023_15_PHI_SEA,SEA,PHI,REG,15,20,17,2023,3
2023_15_PIT_IND,IND,PIT,REG,15,30,13,2023,17
2023_15_SF_ARI,ARI,SF,REG,15,29,45,2023,-16
2023_15_TB_GB,GB,TB,REG,15,20,34,2023,-14
2023_15_WAS_LA,LA,WAS,REG,15,28,20,2023,8
2023_16_ARI_CHI,CHI,ARI,REG,16,27,16,2023,11
2023_16_BAL_SF,SF,BAL,REG,16,19,33,2023,-14
2023_16_BUF_LAC,LAC,BUF,REG,16,22,24,2023,-2
2023_16_CIN_PIT,PIT,CIN,REG,16,34,11,2023,23
2023_16_CLE_HOU,HOU,CLE,REG,16,22,36,2023,-14
2023_16_DAL_MIA,MIA,DAL,REG,16,22,20,2023,2
2023_16_DET_MIN,MIN,DET,REG,16,24,30,2023,-6
2023_16_GB_CAR,CAR,GB,REG,16,30,33,2023,-3
2023_16_IND_ATL,ATL,IND,REG,16,29,10,2023,19
2023_16_JAX_TB,TB,JAX,REG,16,30,12,2023,18
2023_16_LV_KC,KC,LV,REG,16,14,20,2023,-6
2023_16_NE_DEN,DEN,NE,REG,16,23,26,2023,-3
2023_16_NO_LA,LA,NO,REG,16,30,22,2023,8
2023_16_NYG_PHI,PHI,NYG,REG,16,33,25,2023,8
2023_16_SEA_TEN,TEN,SEA,REG,16,17,20,2023,-3
2023_16_WAS_NYJ,NYJ,WAS,REG,16,30,28,2023,2
2023_17_ARI_PHI,PHI,ARI,REG,17,31,35,2023,-4
2023_17_ATL_CHI,CHI,ATL,REG,17,37,17,2023,20
2023_17_CAR_JAX,JAX,CAR,REG,17,26,0,2023,26
2023_17_CIN_KC,KC,CIN,REG,17,25,17,2023,8
2023_17_DET_DAL,DAL,DET,REG,17,20,19,2023,1
2023_17_GB_MIN,MIN,GB,REG,17,10,33,2023,-23
2023_17_LA_NYG,NYG,LA,REG,17,25,26,2023,-1
2023_17_LAC_DEN,DEN,LAC,REG,17,16,9,2023,7
2023_17_LV_IND,IND,LV,REG,17,23,20,2023,3
2023_17_MIA_BAL,BAL,MIA,REG,17,56,19,2023,37
2023_17_NE_BUF,BUF,NE,REG,17,27,21,2023,6
2023_17_NO_TB,TB,NO,REG,17,13,23,2023,-10
2023_17_NYJ_CLE,CLE,NYJ,REG,17,37,20,2023,17
2023_17_PIT_SEA,SEA,PIT,REG,17,23,30,2023,-7
2023_17_SF_WAS,WAS,SF,REG,17,10,27,2023,-17
2023_17_TEN_HOU,HOU,TEN,REG,17,26,3,2023,23
2023_18_ATL_NO,NO,ATL,REG,18,48,17,2023,31
2023_18_BUF_MIA,MIA,BUF,REG,18,14,21,2023,-7
2023_18_CHI_GB,GB,CHI,REG,18,17,9,2023,8
2023_18_CLE_CIN,CIN,CLE,REG,18,31,14,2023,17
2023_18_DAL_WAS,WAS,DAL,REG,18,10,38,2023,-28
2023_18_DEN_LV,LV,DEN,REG,18,27,14,2023,13
2023_18_HOU_IND,IND,HOU,REG,18,19,23,2023,-4
2023_18_JAX_TEN,TEN,JAX,REG,18,28,20,2023,8
2023_18_KC_LAC,LAC,KC,REG,18,12,13,2023,-1
2023_18_LA_SF,SF,LA,REG,18,20,21,2023,-1
2023_18_MIN_DET,DET,MIN,REG,18,30,20,2023,10
2023_18_NYJ_NE,NE,NYJ,REG,18,3,17,2023,-14
2023_18_PHI_NYG,NYG,PHI,REG,18,27,10,2023,17
2023_18_PIT_BAL,BAL,PIT,REG,18,10,17,2023,-7
2023_18_SEA_ARI,ARI,SEA,REG,18,20,21,2023,-1
2023_18_TB_CAR,CAR,TB,REG,18,0,9,2023,-9
2023_19_CLE_HOU,HOU,CLE,POST,19,45,14,2023,31
2023_19_GB_DAL,DAL,GB,POST,19,32,48,2023,-16
2023_19_LA_DET,DET,LA,POST,19,24,23,2023,1
2023_19_MIA_KC,KC,MIA,POST,19,26,7,2023,19
2023_19_PHI_TB,TB,PHI,POST,19,32,9,2023,23
2023_19_PIT_BUF,BUF,PIT,POST,19,31,17,2023,14
2023_20_GB_SF,SF,GB,POST,20,24,21,2023,3
2023_20_HOU_BAL,BAL,HOU,POST,20,34,10,2023,24
2023_20_KC_BUF,BUF,KC,POST,20,24,27,2023,-3
2023_20_TB_DET,DET,TB,POST,20,31,23,2023,8
2023_21_DET_SF,SF,DET,POST,21,34,31,2023,3
2023_21_KC_BAL,BAL,KC,POST,21,10,17,2023,-7
2023_22_SF_KC,KC,SF,POST,22,25,22,2023,3
